日期,假期,管制站,入境 / 出境,香港居民,內地訪客,其他訪客,總計
4/4/2019,四,機場,入境,29331,15048,32239,76618
4/4/2019,四,機場,出境,48963,11905,21276,82144
4/4/2019,四,高鐵西九龍,入境,7063,17165,1557,25785
4/4/2019,四,高鐵西九龍,出境,20618,9134,873,30625
4/4/2019,四,紅磡,入境,1871,1123,402,3396
4/4/2019,四,紅磡,出境,4581,920,318,5819
4/4/2019,四,羅湖,入境,75438,22606,1957,100001
4/4/2019,四,羅湖,出境,158537,24415,1933,184885
4/4/2019,四,落馬洲支線,入境,45863,21225,894,67982
4/4/2019,四,落馬洲支線,出境,64735,19131,655,84521
4/4/2019,四,港珠澳大橋,入境,10268,7215,3396,20879
4/4/2019,四,港珠澳大橋,出境,23082,9213,3886,36181
4/4/2019,四,落馬洲,入境,24220,9707,1557,35484
4/4/2019,四,落馬洲,出境,32913,6883,873,40669
4/4/2019,四,文錦渡,入境,3538,1601,42,5181
4/4/2019,四,文錦渡,出境,4715,1341,57,6113
4/4/2019,四,沙頭角,入境,3035,873,214,4122
4/4/2019,四,沙頭角,出境,5414,784,116,6314
4/4/2019,四,深圳灣,入境,28058,18747,2348,49153
4/4/2019,四,深圳灣,出境,58317,18170,1523,78010
4/4/2019,四,中國客運碼頭,入境,2617,1448,1621,5686
4/4/2019,四,中國客運碼頭,出境,6263,1742,1534,9539
4/4/2019,四,港口管制,入境,1,0,156,157
4/4/2019,四,港口管制,出境,2,0,7,9
4/4/2019,四,啟德郵輪碼頭,入境,622,173,28,823
4/4/2019,四,啟德郵輪碼頭,出境,578,135,60,773
4/4/2019,四,港澳客輪碼頭,入境,9137,3465,4667,17269
4/4/2019,四,港澳客輪碼頭,出境,12921,1413,3968,18302
4/4/2019,四,屯門客運碼頭,入境,579,11,32,622
4/4/2019,四,屯門客運碼頭,出境,882,19,19,920
5/4/2019,四,機場,入境,26473,15022,28019,69514
5/4/2019,四,機場,出境,36156,10175,21923,68254
5/4/2019,四,高鐵西九龍,入境,8611,39301,2005,49917
5/4/2019,四,高鐵西九龍,出境,19026,20803,1028,40857
5/4/2019,四,紅磡,入境,2820,2406,513,5739
5/4/2019,四,紅磡,出境,5245,1205,341,6791
5/4/2019,四,羅湖,入境,116763,48377,2332,167472
5/4/2019,四,羅湖,出境,126522,49229,2165,177916
5/4/2019,四,落馬洲支線,入境,57172,54625,1047,112844
5/4/2019,四,落馬洲支線,出境,64797,45106,793,110696
5/4/2019,四,港珠澳大橋,入境,21630,13976,5692,41298
5/4/2019,四,港珠澳大橋,出境,30200,17421,5440,53061
5/4/2019,四,落馬洲,入境,31161,12980,1262,45403
5/4/2019,四,落馬洲,出境,31262,12183,832,44277
5/4/2019,四,文錦渡,入境,2251,4203,91,6545
5/4/2019,四,文錦渡,出境,2772,2678,61,5511
5/4/2019,四,沙頭角,入境,4227,2097,165,6489
5/4/2019,四,沙頭角,出境,5077,1289,78,6444
5/4/2019,四,深圳灣,入境,40928,40828,2188,83944
5/4/2019,四,深圳灣,出境,49773,34222,1506,85501
5/4/2019,四,中國客運碼頭,入境,3607,3088,1632,8327
5/4/2019,四,中國客運碼頭,出境,7095,2258,1601,10954
5/4/2019,四,港口管制,入境,23,0,140,163
5/4/2019,四,港口管制,出境,1,4,6,11
5/4/2019,四,啟德郵輪碼頭,入境,1071,3598,870,5539
5/4/2019,四,啟德郵輪碼頭,出境,3543,3971,344,7858
5/4/2019,四,港澳客輪碼頭,入境,13230,2094,5888,21212
5/4/2019,四,港澳客輪碼頭,出境,14860,2114,3883,20857
5/4/2019,四,屯門客運碼頭,入境,1190,21,61,1272
5/4/2019,四,屯門客運碼頭,出境,1500,21,34,1555
6/4/2019,四,機場,入境,33868,11514,25451,70833
6/4/2019,四,機場,出境,26966,12658,25204,64828
6/4/2019,四,高鐵西九龍,入境,13517,32986,1439,47942
6/4/2019,四,高鐵西九龍,出境,8403,29049,1166,38618
6/4/2019,四,紅磡,入境,3099,1630,348,5077
6/4/2019,四,紅磡,出境,2222,2039,378,4639
6/4/2019,四,羅湖,入境,107995,46596,2360,156951
6/4/2019,四,羅湖,出境,91518,58985,2567,153070
6/4/2019,四,落馬洲支線,入境,49496,57220,1021,107737
6/4/2019,四,落馬洲支線,出境,51143,57912,986,110041
6/4/2019,四,港珠澳大橋,入境,20781,15792,4833,41406
6/4/2019,四,港珠澳大橋,出境,19254,17894,4790,41938
6/4/2019,四,落馬洲,入境,29620,11672,814,42106
6/4/2019,四,落馬洲,出境,23474,12666,1073,37213
6/4/2019,四,文錦渡,入境,2001,4264,35,6300
6/4/2019,四,文錦渡,出境,2013,3294,38,5345
6/4/2019,四,沙頭角,入境,3069,1996,130,5195
6/4/2019,四,沙頭角,出境,2685,1553,164,4402
6/4/2019,四,深圳灣,入境,37567,41015,1942,80524
6/4/2019,四,深圳灣,出境,30135,42571,2256,74962
6/4/2019,四,中國客運碼頭,入境,4514,2796,1679,8989
6/4/2019,四,中國客運碼頭,出境,3318,3523,1667,8508
6/4/2019,四,港口管制,入境,8,0,46,54
6/4/2019,四,港口管制,出境,1,2,12,15
6/4/2019,四,啟德郵輪碼頭,入境,624,339,35,998
6/4/2019,四,啟德郵輪碼頭,出境,831,230,682,1743
6/4/2019,四,港澳客輪碼頭,入境,12723,2325,5293,20341
6/4/2019,四,港澳客輪碼頭,出境,11907,2510,4803,19220
6/4/2019,四,屯門客運碼頭,入境,923,49,57,1029
6/4/2019,四,屯門客運碼頭,出境,906,32,34,972
7/4/2019,四,機場,入境,51416,13499,22178,87093
7/4/2019,四,機場,出境,29332,16547,33015,78894
7/4/2019,四,高鐵西九龍,入境,23788,14291,878,38957
7/4/2019,四,高鐵西九龍,出境,5177,28620,1892,35689
7/4/2019,四,紅磡,入境,5437,1404,293,7134
7/4/2019,四,紅磡,出境,1546,2074,556,4176
7/4/2019,四,羅湖,入境,146316,26313,1774,174403
7/4/2019,四,羅湖,出境,69191,33734,2227,105152
7/4/2019,四,落馬洲支線,入境,62183,27444,607,90234
7/4/2019,四,落馬洲支線,出境,36968,31131,1046,69145
7/4/2019,四,港珠澳大橋,入境,31494,9876,4156,45526
7/4/2019,四,港珠澳大橋,出境,14405,12006,4923,31334
7/4/2019,四,落馬洲,入境,39200,10546,692,50438
7/4/2019,四,落馬洲,出境,18645,10640,1832,31117
7/4/2019,四,文錦渡,入境,2817,2428,36,5281
7/4/2019,四,文錦渡,出境,1516,2088,50,3654
7/4/2019,四,沙頭角,入境,4531,1263,70,5864
7/4/2019,四,沙頭角,出境,2280,1247,193,3720
7/4/2019,四,深圳灣,入境,58655,21734,1313,81702
7/4/2019,四,深圳灣,出境,22973,29817,3102,55892
7/4/2019,四,中國客運碼頭,入境,7271,1807,1193,10271
7/4/2019,四,中國客運碼頭,出境,2272,2427,1793,6492
7/4/2019,四,港口管制,入境,1,0,84,85
7/4/2019,四,港口管制,出境,1,1,26,28
7/4/2019,四,啟德郵輪碼頭,入境,3748,771,2265,6784
7/4/2019,四,啟德郵輪碼頭,出境,487,977,61,1525
7/4/2019,四,港澳客輪碼頭,入境,14749,1718,3679,20146
7/4/2019,四,港澳客輪碼頭,出境,8350,1418,4496,14264
7/4/2019,四,屯門客運碼頭,入境,1120,56,36,1212
7/4/2019,四,屯門客運碼頭,出境,743,29,37,809
18/4/2019,三,機場,入境,37783,12809,27943,78535
18/4/2019,三,機場,出境,80346,6535,17371,104252
18/4/2019,三,高鐵西九龍,入境,7463,14217,2257,23937
18/4/2019,三,高鐵西九龍,出境,31938,14298,1646,47882
18/4/2019,三,紅磡,入境,1545,1167,691,3403
18/4/2019,三,紅磡,出境,3916,1183,384,5483
18/4/2019,三,羅湖,入境,73239,24496,1856,99591
18/4/2019,三,羅湖,出境,122524,28958,2190,153672
18/4/2019,三,落馬洲支線,入境,41032,21305,827,63164
18/4/2019,三,落馬洲支線,出境,63481,20216,757,84454
18/4/2019,三,港珠澳大橋,入境,12686,9453,4795,26934
18/4/2019,三,港珠澳大橋,出境,27928,26476,4704,59108
18/4/2019,三,落馬洲,入境,22798,15944,1440,40182
18/4/2019,三,落馬洲,出境,30783,11279,1250,43312
18/4/2019,三,文錦渡,入境,2398,2425,34,4857
18/4/2019,三,文錦渡,出境,3160,1705,47,4912
18/4/2019,三,沙頭角,入境,1985,874,109,2968
18/4/2019,三,沙頭角,出境,3248,841,100,4189
18/4/2019,三,深圳灣,入境,25395,18373,2236,46004
18/4/2019,三,深圳灣,出境,51346,22183,1935,75464
18/4/2019,三,中國客運碼頭,入境,2657,1357,1632,5646
18/4/2019,三,中國客運碼頭,出境,5548,1973,1763,9284
18/4/2019,三,港口管制,入境,15,2,97,114
18/4/2019,三,港口管制,出境,3,3,31,37
18/4/2019,三,啟德郵輪碼頭,入境,677,3276,103,4056
18/4/2019,三,啟德郵輪碼頭,出境,4494,438,172,5104
18/4/2019,三,港澳客輪碼頭,入境,10586,1261,4806,16653
18/4/2019,三,港澳客輪碼頭,出境,15661,1531,4522,21714
18/4/2019,三,屯門客運碼頭,入境,824,15,41,880
18/4/2019,三,屯門客運碼頭,出境,1013,14,24,1051
19/4/2019,三,機場,入境,32979,12242,30750,75971
19/4/2019,三,機場,出境,73456,7406,21236,102098
19/4/2019,三,高鐵西九龍,入境,7724,11831,2691,22246
19/4/2019,三,高鐵西九龍,出境,47759,9999,998,58756
19/4/2019,三,紅磡,入境,1483,1207,1007,3697
19/4/2019,三,紅磡,出境,7147,765,258,8170
19/4/2019,三,羅湖,入境,84852,18499,2155,105506
19/4/2019,三,羅湖,出境,184063,21549,2415,208027
19/4/2019,三,落馬洲支線,入境,48534,16086,769,65389
19/4/2019,三,落馬洲支線,出境,114018,14541,702,129261
19/4/2019,三,港珠澳大橋,入境,18963,8731,6901,34595
19/4/2019,三,港珠澳大橋,出境,57076,20711,5726,83513
19/4/2019,三,落馬洲,入境,24777,10659,1734,37170
19/4/2019,三,落馬洲,出境,39692,7582,1129,48403
19/4/2019,三,文錦渡,入境,1323,1648,46,3017
19/4/2019,三,文錦渡,出境,3416,1336,126,4878
19/4/2019,三,沙頭角,入境,1759,592,142,2493
19/4/2019,三,沙頭角,出境,4770,559,116,5445
19/4/2019,三,深圳灣,入境,24803,13266,2772,40841
19/4/2019,三,深圳灣,出境,72830,13754,1665,88249
19/4/2019,三,中國客運碼頭,入境,2778,1217,1850,5845
19/4/2019,三,中國客運碼頭,出境,10636,1421,1417,13474
19/4/2019,三,港口管制,入境,1,0,104,105
19/4/2019,三,港口管制,出境,0,0,3,3
19/4/2019,三,啟德郵輪碼頭,入境,1001,3043,47,4091
19/4/2019,三,啟德郵輪碼頭,出境,3879,728,631,5238
19/4/2019,三,港澳客輪碼頭,入境,13216,1321,5367,19904
19/4/2019,三,港澳客輪碼頭,出境,21872,1487,4687,28046
19/4/2019,三,屯門客運碼頭,入境,1049,6,97,1152
19/4/2019,三,屯門客運碼頭,出境,1791,25,23,1839
20/4/2019,三,機場,入境,43572,12896,25898,82366
20/4/2019,三,機場,出境,44172,10732,28831,83735
20/4/2019,三,高鐵西九龍,入境,12396,19531,2552,34479
20/4/2019,三,高鐵西九龍,出境,24175,15840,1402,41417
20/4/2019,三,紅磡,入境,2163,1251,648,4062
20/4/2019,三,紅磡,出境,4594,1000,438,6032
20/4/2019,三,羅湖,入境,96913,30500,2665,130078
20/4/2019,三,羅湖,出境,120410,31567,2312,154289
20/4/2019,三,落馬洲支線,入境,53428,33666,982,88076
20/4/2019,三,落馬洲支線,出境,69004,30732,711,100447
20/4/2019,三,港珠澳大橋,入境,29980,15847,5741,51568
20/4/2019,三,港珠澳大橋,出境,36536,22396,5715,64647
20/4/2019,三,落馬洲,入境,29161,13079,1522,43762
20/4/2019,三,落馬洲,出境,25983,10404,1056,37443
20/4/2019,三,文錦渡,入境,1547,3188,77,4812
20/4/2019,三,文錦渡,出境,2007,1809,24,3840
20/4/2019,三,沙頭角,入境,2430,1122,184,3736
20/4/2019,三,沙頭角,出境,3397,918,82,4397
20/4/2019,三,深圳灣,入境,33155,27043,2906,63104
20/4/2019,三,深圳灣,出境,45603,27062,1764,74429
20/4/2019,三,中國客運碼頭,入境,4449,1503,1498,7450
20/4/2019,三,中國客運碼頭,出境,6131,1505,1624,9260
20/4/2019,三,港口管制,入境,2,1,159,162
20/4/2019,三,港口管制,出境,0,0,15,15
20/4/2019,三,啟德郵輪碼頭,入境,911,192,3812,4915
20/4/2019,三,啟德郵輪碼頭,出境,763,371,27,1161
20/4/2019,三,港澳客輪碼頭,入境,17119,1278,4844,23241
20/4/2019,三,港澳客輪碼頭,出境,16922,1643,4847,23412
20/4/2019,三,屯門客運碼頭,入境,1395,14,46,1455
20/4/2019,三,屯門客運碼頭,出境,1285,24,43,1352
21/4/2019,三,機場,入境,59308,11766,23072,94146
21/4/2019,三,機場,出境,39595,12921,34322,86838
21/4/2019,三,高鐵西九龍,入境,26608,14750,1437,42795
21/4/2019,三,高鐵西九龍,出境,13050,18736,2042,33828
21/4/2019,三,紅磡,入境,5777,1235,355,7367
21/4/2019,三,紅磡,出境,2079,1287,574,3940
21/4/2019,三,羅湖,入境,146295,29269,2410,177974
21/4/2019,三,羅湖,出境,96370,35486,2580,134436
21/4/2019,三,落馬洲支線,入境,77898,36318,872,115088
21/4/2019,三,落馬洲支線,出境,59928,33836,1011,94775
21/4/2019,三,港珠澳大橋,入境,44425,14458,5691,64574
21/4/2019,三,港珠澳大橋,出境,32780,20520,7052,60352
21/4/2019,三,落馬洲,入境,41619,15990,979,58588
21/4/2019,三,落馬洲,出境,24702,13886,1588,40176
21/4/2019,三,文錦渡,入境,2517,5454,127,8098
21/4/2019,三,文錦渡,出境,1678,2517,52,4247
21/4/2019,三,沙頭角,入境,3729,1172,99,5000
21/4/2019,三,沙頭角,出境,2786,1078,150,4014
21/4/2019,三,深圳灣,入境,66178,23812,1869,91859
21/4/2019,三,深圳灣,出境,34068,30006,2645,66719
21/4/2019,三,中國客運碼頭,入境,7999,1014,1156,10169
21/4/2019,三,中國客運碼頭,出境,4595,1681,1679,7955
21/4/2019,三,港口管制,入境,1,0,161,162
21/4/2019,三,港口管制,出境,10,0,5,15
21/4/2019,三,啟德郵輪碼頭,入境,3827,922,996,5745
21/4/2019,三,啟德郵輪碼頭,出境,2858,491,3093,6442
21/4/2019,三,港澳客輪碼頭,入境,21289,1248,4414,26951
21/4/2019,三,港澳客輪碼頭,出境,17532,1427,5153,24112
21/4/2019,三,屯門客運碼頭,入境,1481,21,46,1548
21/4/2019,三,屯門客運碼頭,出境,1462,13,59,1534
22/4/2019,三,機場,入境,82658,7251,17195,107104
22/4/2019,三,機場,出境,45399,9743,28011,83153
22/4/2019,三,高鐵西九龍,入境,39940,9638,1082,50660
22/4/2019,三,高鐵西九龍,出境,8266,7955,2418,18639
22/4/2019,三,紅磡,入境,5440,840,277,6557
22/4/2019,三,紅磡,出境,1598,743,1256,3597
22/4/2019,三,羅湖,入境,162235,22507,2020,186762
22/4/2019,三,羅湖,出境,75943,19584,1992,97519
22/4/2019,三,落馬洲支線,入境,89471,19877,687,110035
22/4/2019,三,落馬洲支線,出境,47412,13919,616,61947
22/4/2019,三,港珠澳大橋,入境,45025,10285,4357,59667
22/4/2019,三,港珠澳大橋,出境,19365,24762,5895,50022
22/4/2019,三,落馬洲,入境,49762,14631,954,65347
22/4/2019,三,落馬洲,出境,20822,7209,1341,29372
22/4/2019,三,文錦渡,入境,2800,2580,34,5414
22/4/2019,三,文錦渡,出境,1521,1166,18,2705
22/4/2019,三,沙頭角,入境,4266,694,74,5034
22/4/2019,三,沙頭角,出境,2225,463,109,2797
22/4/2019,三,深圳灣,入境,70670,14154,1618,86442
22/4/2019,三,深圳灣,出境,25069,12556,2107,39732
22/4/2019,三,中國客運碼頭,入境,9496,1060,1042,11598
22/4/2019,三,中國客運碼頭,出境,2842,1123,1567,5532
22/4/2019,三,港口管制,入境,2,44,87,133
22/4/2019,三,港口管制,出境,0,45,5,50
22/4/2019,三,啟德郵輪碼頭,入境,643,368,27,1038
22/4/2019,三,啟德郵輪碼頭,出境,493,318,1386,2197
22/4/2019,三,港澳客輪碼頭,入境,23368,1199,3868,28435
22/4/2019,三,港澳客輪碼頭,出境,9550,1221,4086,14857
22/4/2019,三,屯門客運碼頭,入境,1546,12,43,1601
22/4/2019,三,屯門客運碼頭,出境,787,20,49,856
30/4/2019,五,機場,入境,35253,18469,25397,79119
30/4/2019,五,機場,出境,25858,23605,27297,76760
30/4/2019,五,高鐵西九龍,入境,7720,23753,1677,33150
30/4/2019,五,高鐵西九龍,出境,5485,13655,1827,20967
30/4/2019,五,紅磡,入境,2317,2007,401,4725
30/4/2019,五,紅磡,出境,1837,1469,1361,4667
30/4/2019,五,羅湖,入境,80230,31198,2264,113692
30/4/2019,五,羅湖,出境,92340,28058,2163,122561
30/4/2019,五,落馬洲支線,入境,47800,26062,853,74715
30/4/2019,五,落馬洲支線,出境,51565,20598,576,72739
30/4/2019,五,港珠澳大橋,入境,11523,10152,3390,25065
30/4/2019,五,港珠澳大橋,出境,12047,13241,3406,28694
30/4/2019,五,落馬洲,入境,25022,12827,1755,39604
30/4/2019,五,落馬洲,出境,25689,9158,974,35821
30/4/2019,五,文錦渡,入境,3429,2289,61,5779
30/4/2019,五,文錦渡,出境,3815,1661,47,5523
30/4/2019,五,沙頭角,入境,2891,1366,177,4434
30/4/2019,五,沙頭角,出境,2911,849,85,3845
30/4/2019,五,深圳灣,入境,31337,27070,2350,60757
30/4/2019,五,深圳灣,出境,29728,20107,1764,51599
30/4/2019,五,中國客運碼頭,入境,2630,2159,1831,6620
30/4/2019,五,中國客運碼頭,出境,2112,2172,1926,6210
30/4/2019,五,港口管制,入境,6,0,92,98
30/4/2019,五,港口管制,出境,1,0,14,15
30/4/2019,五,啟德郵輪碼頭,入境,658,292,45,995
30/4/2019,五,啟德郵輪碼頭,出境,868,195,41,1104
30/4/2019,五,港澳客輪碼頭,入境,9674,1874,5052,16600
30/4/2019,五,港澳客輪碼頭,出境,9539,1979,4449,15967
30/4/2019,五,屯門客運碼頭,入境,675,19,27,721
30/4/2019,五,屯門客運碼頭,出境,597,6,20,623
1/5/2019,五,機場,入境,35782,20271,28085,84138
1/5/2019,五,機場,出境,31266,20266,27935,79467
1/5/2019,五,高鐵西九龍,入境,6887,47187,1720,55794
1/5/2019,五,高鐵西九龍,出境,5201,21496,1604,28301
1/5/2019,五,紅磡,入境,1683,3407,491,5581
1/5/2019,五,紅磡,出境,1367,1542,502,3411
1/5/2019,五,羅湖,入境,84407,59994,1923,146324
1/5/2019,五,羅湖,出境,70630,53777,1884,126291
1/5/2019,五,落馬洲支線,入境,44831,56860,979,102670
1/5/2019,五,落馬洲支線,出境,39410,41499,678,81587
1/5/2019,五,港珠澳大橋,入境,16878,17781,3724,38383
1/5/2019,五,港珠澳大橋,出境,15229,19389,4254,38872
1/5/2019,五,落馬洲,入境,26941,19661,1263,47865
1/5/2019,五,落馬洲,出境,19443,10858,691,30992
1/5/2019,五,文錦渡,入境,1525,5089,66,6680
1/5/2019,五,文錦渡,出境,1351,2575,18,3944
1/5/2019,五,沙頭角,入境,1952,2548,152,4652
1/5/2019,五,沙頭角,出境,1735,1458,71,3264
1/5/2019,五,深圳灣,入境,27065,48123,2302,77490
1/5/2019,五,深圳灣,出境,21906,31125,1355,54386
1/5/2019,五,中國客運碼頭,入境,1871,3804,1665,7340
1/5/2019,五,中國客運碼頭,出境,1409,3009,1718,6136
1/5/2019,五,港口管制,入境,6,0,39,45
1/5/2019,五,港口管制,出境,0,0,0,0
1/5/2019,五,啟德郵輪碼頭,入境,869,196,35,1100
1/5/2019,五,啟德郵輪碼頭,出境,654,670,27,1351
1/5/2019,五,港澳客輪碼頭,入境,9358,2874,4473,16705
1/5/2019,五,港澳客輪碼頭,出境,6895,2642,3823,13360
1/5/2019,五,屯門客運碼頭,入境,594,37,44,675
1/5/2019,五,屯門客運碼頭,出境,532,33,28,593
2/5/2019,五,機場,入境,25793,18458,27307,71558
2/5/2019,五,機場,出境,24758,12761,24278,61797
2/5/2019,五,高鐵西九龍,入境,4837,38710,1607,45154
2/5/2019,五,高鐵西九龍,出境,4512,28114,1109,33735
2/5/2019,五,紅磡,入境,1337,2389,492,4218
2/5/2019,五,紅磡,出境,1543,2240,376,4159
2/5/2019,五,羅湖,入境,69115,64926,2174,136215
2/5/2019,五,羅湖,出境,68197,80712,2302,151211
2/5/2019,五,落馬洲支線,入境,42030,68084,1026,111140
2/5/2019,五,落馬洲支線,出境,41445,63463,939,105847
2/5/2019,五,港珠澳大橋,入境,8733,23286,2933,34952
2/5/2019,五,港珠澳大橋,出境,8586,28437,3153,40176
2/5/2019,五,落馬洲,入境,21332,16720,966,39018
2/5/2019,五,落馬洲,出境,18559,16763,932,36254
2/5/2019,五,文錦渡,入境,3542,5552,51,9145
2/5/2019,五,文錦渡,出境,3703,3583,69,7355
2/5/2019,五,沙頭角,入境,2403,2658,118,5179
2/5/2019,五,沙頭角,出境,2465,1946,96,4507
2/5/2019,五,深圳灣,入境,24279,50809,1976,77064
2/5/2019,五,深圳灣,出境,23619,48160,1620,73399
2/5/2019,五,中國客運碼頭,入境,1552,3873,1652,7077
2/5/2019,五,中國客運碼頭,出境,1699,4481,1910,8090
2/5/2019,五,港口管制,入境,1,0,52,53
2/5/2019,五,港口管制,出境,3,0,35,38
2/5/2019,五,啟德郵輪碼頭,入境,653,670,34,1357
2/5/2019,五,啟德郵輪碼頭,出境,549,687,43,1279
2/5/2019,五,港澳客輪碼頭,入境,7306,3958,4947,16211
2/5/2019,五,港澳客輪碼頭,出境,7231,4316,4689,16236
2/5/2019,五,屯門客運碼頭,入境,426,52,29,507
2/5/2019,五,屯門客運碼頭,出境,537,42,37,616
3/5/2019,五,機場,入境,21716,19456,27771,68943
3/5/2019,五,機場,出境,27917,15539,26252,69708
3/5/2019,五,高鐵西九龍,入境,4740,35174,1793,41707
3/5/2019,五,高鐵西九龍,出境,5741,35264,1056,42061
3/5/2019,五,紅磡,入境,1639,2260,698,4597
3/5/2019,五,紅磡,出境,1823,2868,372,5063
3/5/2019,五,羅湖,入境,69250,50563,1987,121800
3/5/2019,五,羅湖,出境,78735,71630,2360,152725
3/5/2019,五,落馬洲支線,入境,41399,54949,908,97256
3/5/2019,五,落馬洲支線,出境,46938,60150,1003,108091
3/5/2019,五,港珠澳大橋,入境,9021,18567,3481,31069
3/5/2019,五,港珠澳大橋,出境,10719,23441,3620,37780
3/5/2019,五,落馬洲,入境,20105,11909,896,32910
3/5/2019,五,落馬洲,出境,21927,20243,935,43105
3/5/2019,五,文錦渡,入境,3604,5144,35,8783
3/5/2019,五,文錦渡,出境,3787,3606,83,7476
3/5/2019,五,沙頭角,入境,2515,2418,125,5058
3/5/2019,五,沙頭角,出境,2724,1980,113,4817
3/5/2019,五,深圳灣,入境,24439,41360,1929,67728
3/5/2019,五,深圳灣,出境,28730,52698,1755,83183
3/5/2019,五,中國客運碼頭,入境,1810,3500,1804,7114
3/5/2019,五,中國客運碼頭,出境,2041,4627,2192,8860
3/5/2019,五,港口管制,入境,11,0,93,104
3/5/2019,五,港口管制,出境,2,5,21,28
3/5/2019,五,啟德郵輪碼頭,入境,967,2628,271,3866
3/5/2019,五,啟德郵輪碼頭,出境,2959,1379,477,4815
3/5/2019,五,港澳客輪碼頭,入境,7928,3818,5882,17628
3/5/2019,五,港澳客輪碼頭,出境,8538,3830,4880,17248
3/5/2019,五,屯門客運碼頭,入境,431,81,43,555
3/5/2019,五,屯門客運碼頭,出境,510,61,27,598
4/5/2019,五,機場,入境,23936,27260,25096,76292
4/5/2019,五,機場,出境,25189,19613,28495,73297
4/5/2019,五,高鐵西九龍,入境,4192,18881,1319,24392
4/5/2019,五,高鐵西九龍,出境,7542,38495,1195,47232
4/5/2019,五,紅磡,入境,1344,1186,550,3080
4/5/2019,五,紅磡,出境,1942,3062,430,5434
4/5/2019,五,羅湖,入境,74296,28924,1939,105159
4/5/2019,五,羅湖,出境,95441,45200,2051,142692
4/5/2019,五,落馬洲支線,入境,40692,31577,633,72902
4/5/2019,五,落馬洲支線,出境,53223,38681,821,92725
4/5/2019,五,港珠澳大橋,入境,11631,8534,4835,25000
4/5/2019,五,港珠澳大橋,出境,17603,12466,4663,34732
4/5/2019,五,落馬洲,入境,21940,6855,693,29488
4/5/2019,五,落馬洲,出境,25398,17703,975,44076
4/5/2019,五,文錦渡,入境,2007,3767,33,5807
4/5/2019,五,文錦渡,出境,2700,3360,65,6125
4/5/2019,五,沙頭角,入境,2027,1301,79,3407
4/5/2019,五,沙頭角,出境,2501,1699,121,4321
4/5/2019,五,深圳灣,入境,22743,25627,1464,49834
4/5/2019,五,深圳灣,出境,32048,43429,2010,77487
4/5/2019,五,中國客運碼頭,入境,1723,1683,1977,5383
4/5/2019,五,中國客運碼頭,出境,2574,2881,2170,7625
4/5/2019,五,港口管制,入境,0,0,43,43
4/5/2019,五,港口管制,出境,0,0,11,11
4/5/2019,五,啟德郵輪碼頭,入境,720,371,21,1112
4/5/2019,五,啟德郵輪碼頭,出境,839,173,19,1031
4/5/2019,五,港澳客輪碼頭,入境,8378,1864,6218,16460
4/5/2019,五,港澳客輪碼頭,出境,12059,1947,5189,19195
4/5/2019,五,屯門客運碼頭,入境,511,29,47,587
4/5/2019,五,屯門客運碼頭,出境,723,23,38,784
5/5/2019,五,機場,入境,34679,24310,23717,82706
5/5/2019,五,機場,出境,26117,15943,33975,76035
5/5/2019,五,高鐵西九龍,入境,8229,11538,1304,21071
5/5/2019,五,高鐵西九龍,出境,5337,14835,1357,21529
5/5/2019,五,紅磡,入境,1955,1043,396,3394
5/5/2019,五,紅磡,出境,1048,1170,356,2574
5/5/2019,五,羅湖,入境,94880,22753,1818,119451
5/5/2019,五,羅湖,出境,68572,24963,2035,95570
5/5/2019,五,落馬洲支線,入境,48991,19687,547,69225
5/5/2019,五,落馬洲支線,出境,38724,19611,795,59130
5/5/2019,五,港珠澳大橋,入境,16424,6665,3986,27075
5/5/2019,五,港珠澳大橋,出境,11207,8062,5010,24279
5/5/2019,五,落馬洲,入境,27906,6069,675,34650
5/5/2019,五,落馬洲,出境,18564,13092,1587,33243
5/5/2019,五,文錦渡,入境,1899,1571,124,3594
5/5/2019,五,文錦渡,出境,1407,1391,35,2833
5/5/2019,五,沙頭角,入境,2523,960,73,3556
5/5/2019,五,沙頭角,出境,1678,825,127,2630
5/5/2019,五,深圳灣,入境,34813,16479,1286,52578
5/5/2019,五,深圳灣,出境,22756,22776,2231,47763
5/5/2019,五,中國客運碼頭,入境,2273,1199,1368,4840
5/5/2019,五,中國客運碼頭,出境,1424,1402,1915,4741
5/5/2019,五,港口管制,入境,137,0,45,182
5/5/2019,五,港口管制,出境,0,0,1,1
5/5/2019,五,啟德郵輪碼頭,入境,3078,1185,422,4685
5/5/2019,五,啟德郵輪碼頭,出境,959,911,248,2118
5/5/2019,五,港澳客輪碼頭,入境,11381,1042,4632,17055
5/5/2019,五,港澳客輪碼頭,出境,6979,1043,5038,13060
5/5/2019,五,屯門客運碼頭,入境,684,12,24,720
5/5/2019,五,屯門客運碼頭,出境,485,25,35,545
11/5/2019,六,機場,入境,27788,13946,22122,63856
11/5/2019,六,機場,出境,48047,11291,21425,80763
11/5/2019,六,高鐵西九龍,入境,5712,33050,1361,40123
11/5/2019,六,高鐵西九龍,出境,22668,24011,903,47582
11/5/2019,六,紅磡,入境,1056,2025,370,3451
11/5/2019,六,紅磡,出境,3210,1800,242,5252
11/5/2019,六,羅湖,入境,80688,49995,2056,132739
11/5/2019,六,羅湖,出境,138792,54384,1935,195111
11/5/2019,六,落馬洲支線,入境,45228,54593,973,100794
11/5/2019,六,落馬洲支線,出境,72514,50181,874,123569
11/5/2019,六,港珠澳大橋,入境,12431,15448,6448,34327
11/5/2019,六,港珠澳大橋,出境,29859,19660,5789,55308
11/5/2019,六,落馬洲,入境,24314,14386,1154,39854
11/5/2019,六,落馬洲,出境,31585,14310,968,46863
11/5/2019,六,文錦渡,入境,1903,5717,65,7685
11/5/2019,六,文錦渡,出境,3258,3303,49,6610
11/5/2019,六,沙頭角,入境,2014,2192,167,4373
11/5/2019,六,沙頭角,出境,3737,1521,78,5336
11/5/2019,六,深圳灣,入境,25817,43006,2256,71079
11/5/2019,六,深圳灣,出境,51941,41265,1734,94940
11/5/2019,六,中國客運碼頭,入境,1716,2153,1482,5351
11/5/2019,六,中國客運碼頭,出境,4010,2442,1316,7768
11/5/2019,六,港口管制,入境,2,0,51,53
11/5/2019,六,港口管制,出境,243,0,40,283
11/5/2019,六,啟德郵輪碼頭,入境,625,209,28,862
11/5/2019,六,啟德郵輪碼頭,出境,788,299,21,1108
11/5/2019,六,港澳客輪碼頭,入境,9128,1602,4963,15693
11/5/2019,六,港澳客輪碼頭,出境,14803,1637,4051,20491
11/5/2019,六,屯門客運碼頭,入境,496,9,46,551
11/5/2019,六,屯門客運碼頭,出境,877,24,17,918
12/5/2019,六,機場,入境,33832,12382,19602,65816
12/5/2019,六,機場,出境,37741,15363,26262,79366
12/5/2019,六,高鐵西九龍,入境,8428,18914,1048,28390
12/5/2019,六,高鐵西九龍,出境,12988,27043,1470,41501
12/5/2019,六,紅磡,入境,1663,885,262,2810
12/5/2019,六,紅磡,出境,1896,1830,349,4075
12/5/2019,六,羅湖,入境,104208,32653,1744,138605
12/5/2019,六,羅湖,出境,113972,43301,2170,159443
12/5/2019,六,落馬洲支線,入境,58086,39080,651,97817
12/5/2019,六,落馬洲支線,出境,69684,38986,869,109539
12/5/2019,六,港珠澳大橋,入境,23318,12004,5273,40595
12/5/2019,六,港珠澳大橋,出境,35740,17541,6404,59685
12/5/2019,六,落馬洲,入境,31503,12733,690,44926
12/5/2019,六,落馬洲,出境,26409,13636,1291,41336
12/5/2019,六,文錦渡,入境,1853,3520,76,5449
12/5/2019,六,文錦渡,出境,1837,2380,42,4259
12/5/2019,六,沙頭角,入境,2511,1398,89,3998
12/5/2019,六,沙頭角,出境,3070,1441,164,4675
12/5/2019,六,深圳灣,入境,39253,26712,1447,67412
12/5/2019,六,深圳灣,出境,46049,32700,2355,81104
12/5/2019,六,中國客運碼頭,入境,2605,1508,1179,5292
12/5/2019,六,中國客運碼頭,出境,4249,2114,1638,8001
12/5/2019,六,港口管制,入境,1,1,73,75
12/5/2019,六,港口管制,出境,1,3,32,36
12/5/2019,六,啟德郵輪碼頭,入境,788,299,16,1103
12/5/2019,六,啟德郵輪碼頭,出境,606,423,19,1048
12/5/2019,六,港澳客輪碼頭,入境,12837,1405,3693,17935
12/5/2019,六,港澳客輪碼頭,出境,17411,1367,4235,23013
12/5/2019,六,屯門客運碼頭,入境,706,20,33,759
12/5/2019,六,屯門客運碼頭,出境,1345,22,47,1414
13/5/2019,六,機場,入境,57982,11824,19576,89382
13/5/2019,六,機場,出境,34117,12504,21855,68476
13/5/2019,六,高鐵西九龍,入境,26014,12578,904,39496
13/5/2019,六,高鐵西九龍,出境,7068,11259,1023,19350
13/5/2019,六,紅磡,入境,3946,1269,221,5436
13/5/2019,六,紅磡,出境,1567,906,266,2739
13/5/2019,六,羅湖,入境,164915,24930,1539,191384
13/5/2019,六,羅湖,出境,92409,23377,1595,117381
13/5/2019,六,落馬洲支線,入境,89393,20282,580,110255
13/5/2019,六,落馬洲支線,出境,58472,15957,594,75023
13/5/2019,六,港珠澳大橋,入境,45565,9184,4580,59329
13/5/2019,六,港珠澳大橋,出境,19675,16100,5500,41275
13/5/2019,六,落馬洲,入境,41186,10190,669,52045
13/5/2019,六,落馬洲,出境,23582,6896,1651,32129
13/5/2019,六,文錦渡,入境,2821,2341,41,5203
13/5/2019,六,文錦渡,出境,1513,1219,30,2762
13/5/2019,六,沙頭角,入境,4132,983,64,5179
13/5/2019,六,沙頭角,出境,2343,706,190,3239
13/5/2019,六,深圳灣,入境,71230,17434,1196,89860
13/5/2019,六,深圳灣,出境,30648,16250,2102,49000
13/5/2019,六,中國客運碼頭,入境,5928,1243,835,8006
13/5/2019,六,中國客運碼頭,出境,2301,1383,1296,4980
13/5/2019,六,港口管制,入境,1,0,50,51
13/5/2019,六,港口管制,出境,0,0,0,0
13/5/2019,六,啟德郵輪碼頭,入境,2883,735,271,3889
13/5/2019,六,啟德郵輪碼頭,出境,1141,339,94,1574
13/5/2019,六,港澳客輪碼頭,入境,20573,1258,3036,24867
13/5/2019,六,港澳客輪碼頭,出境,9064,1193,3568,13825
13/5/2019,六,屯門客運碼頭,入境,1691,19,18,1728
13/5/2019,六,屯門客運碼頭,出境,768,18,38,824
7/6/2019,七,機場,入境,29192,16494,27712,73398
7/6/2019,七,機場,出境,44046,10497,21641,76184
7/6/2019,七,高鐵西九龍,入境,6296,34660,1988,42944
7/6/2019,七,高鐵西九龍,出境,17585,18839,1135,37559
7/6/2019,七,紅磡,入境,1096,2152,423,3671
7/6/2019,七,紅磡,出境,3073,1004,247,4324
7/6/2019,七,羅湖,入境,88261,40486,1994,130741
7/6/2019,七,羅湖,出境,112966,39297,2226,154489
7/6/2019,七,落馬洲支線,入境,49950,40601,972,91523
7/6/2019,七,落馬洲支線,出境,66871,32579,750,100200
7/6/2019,七,港珠澳大橋,入境,18916,10580,6677,36173
7/6/2019,七,港珠澳大橋,出境,28581,11990,5788,46359
7/6/2019,七,落馬洲,入境,28208,10681,1261,40150
7/6/2019,七,落馬洲,出境,28171,8303,837,37311
7/6/2019,七,文錦渡,入境,1344,3420,156,4920
7/6/2019,七,文錦渡,出境,1977,2003,153,4133
7/6/2019,七,沙頭角,入境,1929,1590,170,3689
7/6/2019,七,沙頭角,出境,3018,1061,71,4150
7/6/2019,七,深圳灣,入境,28622,33683,2212,64517
7/6/2019,七,深圳灣,出境,46100,26397,1566,74063
7/6/2019,七,中國客運碼頭,入境,1964,2346,2029,6339
7/6/2019,七,中國客運碼頭,出境,3618,2100,1714,7432
7/6/2019,七,港口管制,入境,1,0,81,82
7/6/2019,七,港口管制,出境,0,0,7,7
7/6/2019,七,啟德郵輪碼頭,入境,1317,1941,1107,4365
7/6/2019,七,啟德郵輪碼頭,出境,2460,1584,928,4972
7/6/2019,七,港澳客輪碼頭,入境,11721,2052,5894,19667
7/6/2019,七,港澳客輪碼頭,出境,12697,1663,4586,18946
7/6/2019,七,屯門客運碼頭,入境,776,24,75,875
7/6/2019,七,屯門客運碼頭,出境,838,22,34,894
8/6/2019,七,機場,入境,36398,12210,22462,71070
8/6/2019,七,機場,出境,30589,11664,25156,67409
8/6/2019,七,高鐵西九龍,入境,7510,30014,1335,38859
8/6/2019,七,高鐵西九龍,出境,7969,27914,1358,37241
8/6/2019,七,紅磡,入境,1624,1454,314,3392
8/6/2019,七,紅磡,出境,1514,1874,363,3751
8/6/2019,七,羅湖,入境,89501,44205,1939,135645
8/6/2019,七,羅湖,出境,94873,54844,2232,151949
8/6/2019,七,落馬洲支線,入境,48825,50451,895,100171
8/6/2019,七,落馬洲支線,出境,53207,50221,992,104420
8/6/2019,七,港珠澳大橋,入境,18264,12678,5466,36408
8/6/2019,七,港珠澳大橋,出境,18536,15056,5495,39087
8/6/2019,七,落馬洲,入境,26913,10124,823,37860
8/6/2019,七,落馬洲,出境,24449,12253,933,37635
8/6/2019,七,文錦渡,入境,1637,4174,157,5968
8/6/2019,七,文錦渡,出境,2052,3077,32,5161
8/6/2019,七,沙頭角,入境,2028,1754,102,3884
8/6/2019,七,沙頭角,出境,2165,1494,111,3770
8/6/2019,七,深圳灣,入境,29193,37573,1534,68300
8/6/2019,七,深圳灣,出境,30071,41554,1734,73359
8/6/2019,七,中國客運碼頭,入境,2064,2301,1591,5956
8/6/2019,七,中國客運碼頭,出境,2206,3055,1825,7086
8/6/2019,七,港口管制,入境,1,0,73,74
8/6/2019,七,港口管制,出境,1,0,6,7
8/6/2019,七,啟德郵輪碼頭,入境,745,1569,128,2442
8/6/2019,七,啟德郵輪碼頭,出境,889,1605,119,2613
8/6/2019,七,港澳客輪碼頭,入境,11788,2338,5827,19953
8/6/2019,七,港澳客輪碼頭,出境,11781,2377,5198,19356
8/6/2019,七,屯門客運碼頭,入境,700,35,88,823
8/6/2019,七,屯門客運碼頭,出境,709,93,43,845
9/6/2019,七,機場,入境,56811,14388,20219,91418
9/6/2019,七,機場,出境,30351,16966,34586,81903
9/6/2019,七,高鐵西九龍,入境,18151,12846,997,31994
9/6/2019,七,高鐵西九龍,出境,5384,26734,1726,33844
9/6/2019,七,紅磡,入境,4334,937,219,5490
9/6/2019,七,紅磡,出境,1189,2663,482,4334
9/6/2019,七,羅湖,入境,133493,26168,1603,161264
9/6/2019,七,羅湖,出境,71579,36551,1964,110094
9/6/2019,七,落馬洲支線,入境,61414,27217,624,89255
9/6/2019,七,落馬洲支線,出境,38295,30058,921,69274
9/6/2019,七,港珠澳大橋,入境,30091,8834,4610,43535
9/6/2019,七,港珠澳大橋,出境,15058,10649,5850,31557
9/6/2019,七,落馬洲,入境,35606,7872,654,44132
9/6/2019,七,落馬洲,出境,18553,11066,1335,30954
9/6/2019,七,文錦渡,入境,2214,2542,142,4898
9/6/2019,七,文錦渡,出境,1257,2382,23,3662
9/6/2019,七,沙頭角,入境,3708,1106,60,4874
9/6/2019,七,沙頭角,出境,1639,1205,170,3014
9/6/2019,七,深圳灣,入境,57738,21928,1438,81104
9/6/2019,七,深圳灣,出境,24236,31655,2386,58277
9/6/2019,七,中國客運碼頭,入境,4488,1359,1123,6970
9/6/2019,七,中國客運碼頭,出境,1641,2270,1756,5667
9/6/2019,七,港口管制,入境,1,0,115,116
9/6/2019,七,港口管制,出境,1,0,10,11
9/6/2019,七,啟德郵輪碼頭,入境,2610,1640,895,5145
9/6/2019,七,啟德郵輪碼頭,出境,1160,1615,326,3101
9/6/2019,七,港澳客輪碼頭,入境,15046,1645,3689,20380
9/6/2019,七,港澳客輪碼頭,出境,8479,1542,4446,14467
9/6/2019,七,屯門客運碼頭,入境,945,26,41,1012
9/6/2019,七,屯門客運碼頭,出境,727,29,95,851
29/6/2019,八,機場,入境,37398,17109,23204,77711
29/6/2019,八,機場,出境,54954,11744,19899,86597
29/6/2019,八,高鐵西九龍,入境,5896,24647,1307,31850
29/6/2019,八,高鐵西九龍,出境,25129,19847,1044,46020
29/6/2019,八,紅磡,入境,1100,1429,233,2762
29/6/2019,八,紅磡,出境,3850,1249,186,5285
29/6/2019,八,羅湖,入境,79368,38601,1832,119801
29/6/2019,八,羅湖,出境,140956,42719,1766,185441
29/6/2019,八,落馬洲支線,入境,44766,43073,842,88681
29/6/2019,八,落馬洲支線,出境,75455,38917,704,115076
29/6/2019,八,港珠澳大橋,入境,16249,9980,5057,31286
29/6/2019,八,港珠澳大橋,出境,38862,11506,4748,55116
29/6/2019,八,落馬洲,入境,23727,10811,1102,35640
29/6/2019,八,落馬洲,出境,32631,11669,868,45168
29/6/2019,八,文錦渡,入境,1475,3380,63,4918
29/6/2019,八,文錦渡,出境,2666,2786,75,5527
29/6/2019,八,沙頭角,入境,1749,1483,125,3357
29/6/2019,八,沙頭角,出境,3554,1257,98,4909
29/6/2019,八,深圳灣,入境,23962,32500,1907,58369
29/6/2019,八,深圳灣,出境,52505,31922,1307,85734
29/6/2019,八,中國客運碼頭,入境,1916,1863,1235,5014
29/6/2019,八,中國客運碼頭,出境,5099,1953,1106,8158
29/6/2019,八,港口管制,入境,1,0,31,32
29/6/2019,八,港口管制,出境,1,2,39,42
29/6/2019,八,啟德郵輪碼頭,入境,753,304,22,1079
29/6/2019,八,啟德郵輪碼頭,出境,882,332,24,1238
29/6/2019,八,港澳客輪碼頭,入境,10151,1586,4520,16257
29/6/2019,八,港澳客輪碼頭,出境,18238,1577,3837,23652
29/6/2019,八,屯門客運碼頭,入境,641,14,63,718
29/6/2019,八,屯門客運碼頭,出境,1031,18,18,1067
30/6/2019,八,機場,入境,43250,15320,18794,77364
30/6/2019,八,機場,出境,44710,15450,24963,85123
30/6/2019,八,高鐵西九龍,入境,9293,15836,1040,26169
30/6/2019,八,高鐵西九龍,出境,14139,21053,1399,36591
30/6/2019,八,紅磡,入境,1942,1004,192,3138
30/6/2019,八,紅磡,出境,1990,1559,290,3839
30/6/2019,八,羅湖,入境,104519,30487,1473,136479
30/6/2019,八,羅湖,出境,122510,38672,1766,162948
30/6/2019,八,落馬洲支線,入境,56305,36909,637,93851
30/6/2019,八,落馬洲支線,出境,72234,33436,780,106450
30/6/2019,八,港珠澳大橋,入境,25146,8914,4251,38311
30/6/2019,八,港珠澳大橋,出境,40908,12381,5694,58983
30/6/2019,八,落馬洲,入境,31086,11799,755,43640
30/6/2019,八,落馬洲,出境,28817,11139,1128,41084
30/6/2019,八,文錦渡,入境,1436,3076,87,4599
30/6/2019,八,文錦渡,出境,1912,2158,37,4107
30/6/2019,八,沙頭角,入境,2085,1110,83,3278
30/6/2019,八,沙頭角,出境,3114,1140,164,4418
30/6/2019,八,深圳灣,入境,37002,24255,1374,62631
30/6/2019,八,深圳灣,出境,47803,29107,1759,78669
30/6/2019,八,中國客運碼頭,入境,2843,1210,1101,5154
30/6/2019,八,中國客運碼頭,出境,4616,2008,1361,7985
30/6/2019,八,港口管制,入境,1,0,98,99
30/6/2019,八,港口管制,出境,1,0,1,2
30/6/2019,八,啟德郵輪碼頭,入境,4027,730,369,5126
30/6/2019,八,啟德郵輪碼頭,出境,2913,1396,165,4474
30/6/2019,八,港澳客輪碼頭,入境,14749,1305,3044,19098
30/6/2019,八,港澳客輪碼頭,出境,18677,1500,3964,24141
30/6/2019,八,屯門客運碼頭,入境,940,26,18,984
30/6/2019,八,屯門客運碼頭,出境,1382,18,34,1434
1/7/2019,八,機場,入境,59866,12074,16728,88668
1/7/2019,八,機場,出境,37017,11836,22266,71119
1/7/2019,八,高鐵西九龍,入境,27103,10817,870,38790
1/7/2019,八,高鐵西九龍,出境,6065,9425,786,16276
1/7/2019,八,紅磡,入境,4419,741,173,5333
1/7/2019,八,紅磡,出境,1033,607,180,1820
1/7/2019,八,羅湖,入境,162571,22043,1562,186176
1/7/2019,八,羅湖,出境,75924,20236,1397,97557
1/7/2019,八,落馬洲支線,入境,89138,18069,592,107799
1/7/2019,八,落馬洲支線,出境,45686,13617,528,59831
1/7/2019,八,港珠澳大橋,入境,50790,7190,3059,61039
1/7/2019,八,港珠澳大橋,出境,15679,17404,3115,36198
1/7/2019,八,落馬洲,入境,43738,7718,735,52191
1/7/2019,八,落馬洲,出境,19583,6091,974,26648
1/7/2019,八,文錦渡,入境,2452,1712,25,4189
1/7/2019,八,文錦渡,出境,1299,1158,41,2498
1/7/2019,八,沙頭角,入境,4276,817,102,5195
1/7/2019,八,沙頭角,出境,1948,626,101,2675
1/7/2019,八,深圳灣,入境,74568,13825,1327,89720
1/7/2019,八,深圳灣,出境,24419,12909,1657,38985
1/7/2019,八,中國客運碼頭,入境,6540,884,643,8067
1/7/2019,八,中國客運碼頭,出境,2099,1383,1166,4648
1/7/2019,八,港口管制,入境,34,2,52,88
1/7/2019,八,港口管制,出境,0,0,0,0
1/7/2019,八,啟德郵輪碼頭,入境,892,312,23,1227
1/7/2019,八,啟德郵輪碼頭,出境,752,268,23,1043
1/7/2019,八,港澳客輪碼頭,入境,23564,1346,2430,27340
1/7/2019,八,港澳客輪碼頭,出境,7348,1090,2423,10861
1/7/2019,八,屯門客運碼頭,入境,1757,15,14,1786
1/7/2019,八,屯門客運碼頭,出境,709,11,28,748
12/9/2019,九,機場,入境,30117,7169,15287,52573
12/9/2019,九,機場,出境,31514,7130,13718,52362
12/9/2019,九,高鐵西九龍,入境,7361,6441,1131,14933
12/9/2019,九,高鐵西九龍,出境,10195,6220,554,16969
12/9/2019,九,紅磡,入境,2244,622,257,3123
12/9/2019,九,紅磡,出境,1564,798,126,2488
12/9/2019,九,羅湖,入境,74067,18763,1210,94040
12/9/2019,九,羅湖,出境,88787,20792,946,110525
12/9/2019,九,落馬洲支線,入境,47575,16520,669,64764
12/9/2019,九,落馬洲支線,出境,46598,14636,381,61615
12/9/2019,九,港珠澳大橋,入境,9900,1941,1711,13552
12/9/2019,九,港珠澳大橋,出境,11652,2516,2306,16474
12/9/2019,九,落馬洲,入境,22861,5071,1554,29486
12/9/2019,九,落馬洲,出境,20643,5568,620,26831
12/9/2019,九,文錦渡,入境,3930,1317,26,5273
12/9/2019,九,文錦渡,出境,3998,1010,15,5023
12/9/2019,九,沙頭角,入境,3065,741,157,3963
12/9/2019,九,沙頭角,出境,3286,575,41,3902
12/9/2019,九,深圳灣,入境,30227,13261,2112,45600
12/9/2019,九,深圳灣,出境,33385,13932,941,48258
12/9/2019,九,中國客運碼頭,入境,2234,522,694,3450
12/9/2019,九,中國客運碼頭,出境,2127,735,638,3500
12/9/2019,九,港口管制,入境,13,0,48,61
12/9/2019,九,港口管制,出境,37,2,18,57
12/9/2019,九,啟德郵輪碼頭,入境,903,120,10,1033
12/9/2019,九,啟德郵輪碼頭,出境,564,72,9,645
12/9/2019,九,港澳客輪碼頭,入境,8042,473,2204,10719
12/9/2019,九,港澳客輪碼頭,出境,7936,558,2350,10844
12/9/2019,九,屯門客運碼頭,入境,542,5,19,566
12/9/2019,九,屯門客運碼頭,出境,474,2,16,492
13/9/2019,九,機場,入境,23125,6705,14182,44012
13/9/2019,九,機場,出境,35807,4900,12628,53335
13/9/2019,九,高鐵西九龍,入境,4324,8879,1148,14351
13/9/2019,九,高鐵西九龍,出境,17747,6076,635,24458
13/9/2019,九,紅磡,入境,655,543,198,1396
13/9/2019,九,紅磡,出境,2782,400,140,3322
13/9/2019,九,羅湖,入境,55662,19000,1270,75932
13/9/2019,九,羅湖,出境,114682,18488,1285,134455
13/9/2019,九,落馬洲支線,入境,35577,19140,669,55386
13/9/2019,九,落馬洲支線,出境,54467,16446,442,71355
13/9/2019,九,港珠澳大橋,入境,8726,2455,2384,13565
13/9/2019,九,港珠澳大橋,出境,20119,3057,2104,25280
13/9/2019,九,落馬洲,入境,18523,5114,902,24539
13/9/2019,九,落馬洲,出境,24953,4765,483,30201
13/9/2019,九,文錦渡,入境,2987,1227,19,4233
13/9/2019,九,文錦渡,出境,4107,938,69,5114
13/9/2019,九,沙頭角,入境,1919,683,103,2705
13/9/2019,九,沙頭角,出境,3911,532,42,4485
13/9/2019,九,深圳灣,入境,20556,15762,1850,38168
13/9/2019,九,深圳灣,出境,43265,13519,1074,57858
13/9/2019,九,中國客運碼頭,入境,1365,747,864,2976
13/9/2019,九,中國客運碼頭,出境,3329,697,918,4944
13/9/2019,九,港口管制,入境,1,0,71,72
13/9/2019,九,港口管制,出境,0,0,27,27
13/9/2019,九,啟德郵輪碼頭,入境,1045,869,249,2163
13/9/2019,九,啟德郵輪碼頭,出境,3098,1254,275,4627
13/9/2019,九,港澳客輪碼頭,入境,7501,580,2792,10873
13/9/2019,九,港澳客輪碼頭,出境,11006,599,2085,13690
13/9/2019,九,屯門客運碼頭,入境,489,3,41,533
13/9/2019,九,屯門客運碼頭,出境,541,13,12,566
14/9/2019,九,機場,入境,20395,4664,12938,37997
14/9/2019,九,機場,出境,32003,4499,11644,48146
14/9/2019,九,高鐵西九龍,入境,6093,6659,696,13448
14/9/2019,九,高鐵西九龍,出境,11136,6869,779,18784
14/9/2019,九,紅磡,入境,849,449,132,1430
14/9/2019,九,紅磡,出境,1888,424,129,2441
14/9/2019,九,羅湖,入境,82793,18511,1075,102379
14/9/2019,九,羅湖,出境,110124,22267,1259,133650
14/9/2019,九,落馬洲支線,入境,40079,20981,457,61517
14/9/2019,九,落馬洲支線,出境,55090,20993,507,76590
14/9/2019,九,港珠澳大橋,入境,18388,2944,3922,25254
14/9/2019,九,港珠澳大橋,出境,29495,3329,3080,35904
14/9/2019,九,落馬洲,入境,19686,3922,382,23990
14/9/2019,九,落馬洲,出境,25358,4722,555,30635
14/9/2019,九,文錦渡,入境,1371,1544,19,2934
14/9/2019,九,文錦渡,出境,1740,1130,100,2970
14/9/2019,九,沙頭角,入境,2135,697,37,2869
14/9/2019,九,沙頭角,出境,3081,589,60,3730
14/9/2019,九,深圳灣,入境,25073,16494,919,42486
14/9/2019,九,深圳灣,出境,40035,17383,1297,58715
14/9/2019,九,中國客運碼頭,入境,1971,646,886,3503
14/9/2019,九,中國客運碼頭,出境,3712,665,933,5310
14/9/2019,九,港口管制,入境,0,0,25,25
14/9/2019,九,港口管制,出境,0,0,11,11
14/9/2019,九,啟德郵輪碼頭,入境,649,78,63,790
14/9/2019,九,啟德郵輪碼頭,出境,956,91,5,1052
14/9/2019,九,港澳客輪碼頭,入境,9021,664,2478,12163
14/9/2019,九,港澳客輪碼頭,出境,13641,660,2207,16508
14/9/2019,九,屯門客運碼頭,入境,835,16,54,905
14/9/2019,九,屯門客運碼頭,出境,1009,17,28,1054
15/9/2019,九,機場,入境,37821,8445,17401,63667
15/9/2019,九,機場,出境,30257,7053,15846,53156
15/9/2019,九,高鐵西九龍,入境,17025,4631,562,22218
15/9/2019,九,高鐵西九龍,出境,5356,7468,1043,13867
15/9/2019,九,紅磡,入境,3384,393,127,3904
15/9/2019,九,紅磡,出境,971,694,235,1900
15/9/2019,九,羅湖,入境,141696,19402,1009,162107
15/9/2019,九,羅湖,出境,60168,21137,1301,82606
15/9/2019,九,落馬洲支線,入境,62368,18438,383,81189
15/9/2019,九,落馬洲支線,出境,31919,18652,637,51208
15/9/2019,九,港珠澳大橋,入境,33713,2627,2912,39252
15/9/2019,九,港珠澳大橋,出境,12222,3403,3691,19316
15/9/2019,九,落馬洲,入境,33071,4883,454,38408
15/9/2019,九,落馬洲,出境,15026,5068,1237,21331
15/9/2019,九,文錦渡,入境,2414,1389,25,3828
15/9/2019,九,文錦渡,出境,1135,1043,19,2197
15/9/2019,九,沙頭角,入境,4442,687,43,5172
15/9/2019,九,沙頭角,出境,1458,631,119,2208
15/9/2019,九,深圳灣,入境,63214,13675,1144,78033
15/9/2019,九,深圳灣,出境,19979,15990,1891,37860
15/9/2019,九,中國客運碼頭,入境,5548,573,680,6801
15/9/2019,九,中國客運碼頭,出境,1504,779,906,3189
15/9/2019,九,港口管制,入境,0,2,46,48
15/9/2019,九,港口管制,出境,2,0,1,3
15/9/2019,九,啟德郵輪碼頭,入境,3406,1268,178,4852
15/9/2019,九,啟德郵輪碼頭,出境,917,858,351,2126
15/9/2019,九,港澳客輪碼頭,入境,13771,535,1639,15945
15/9/2019,九,港澳客輪碼頭,出境,6845,435,1973,9253
15/9/2019,九,屯門客運碼頭,入境,1306,18,40,1364
15/9/2019,九,屯門客運碼頭,出境,523,6,52,581
28/9/2019,十+十一,機場,入境,30377,8744,10799,49920
28/9/2019,十+十一,機場,出境,41178,13316,15073,69567
28/9/2019,十+十一,高鐵西九龍,入境,5414,8995,1177,15586
28/9/2019,十+十一,高鐵西九龍,出境,12377,8188,463,21028
28/9/2019,十+十一,紅磡,入境,853,538,222,1613
28/9/2019,十+十一,紅磡,出境,1669,470,82,2221
28/9/2019,十+十一,羅湖,入境,71895,23988,1350,97233
28/9/2019,十+十一,羅湖,出境,104733,27358,826,132917
28/9/2019,十+十一,落馬洲支線,入境,39403,28587,676,68666
28/9/2019,十+十一,落馬洲支線,出境,53245,27211,389,80845
28/9/2019,十+十一,港珠澳大橋,入境,12556,2566,2871,17993
28/9/2019,十+十一,港珠澳大橋,出境,22230,3724,2559,28513
28/9/2019,十+十一,落馬洲,入境,20611,6296,1430,28337
28/9/2019,十+十一,落馬洲,出境,24997,6002,428,31427
28/9/2019,十+十一,文錦渡,入境,1656,2343,94,4093
28/9/2019,十+十一,文錦渡,出境,2321,1613,46,3980
28/9/2019,十+十一,沙頭角,入境,1835,981,203,3019
28/9/2019,十+十一,沙頭角,出境,2773,711,43,3527
28/9/2019,十+十一,深圳灣,入境,22713,22119,2733,47565
28/9/2019,十+十一,深圳灣,出境,36725,20244,728,57697
28/9/2019,十+十一,中國客運碼頭,入境,1644,693,786,3123
28/9/2019,十+十一,中國客運碼頭,出境,3626,748,619,4993
28/9/2019,十+十一,港口管制,入境,1,0,35,36
28/9/2019,十+十一,港口管制,出境,2,0,29,31
28/9/2019,十+十一,啟德郵輪碼頭,入境,951,524,58,1533
28/9/2019,十+十一,啟德郵輪碼頭,出境,983,394,34,1411
28/9/2019,十+十一,港澳客輪碼頭,入境,8497,504,2079,11080
28/9/2019,十+十一,港澳客輪碼頭,出境,13343,554,1938,15835
28/9/2019,十+十一,屯門客運碼頭,入境,619,10,25,654
28/9/2019,十+十一,屯門客運碼頭,出境,880,14,19,913
29/9/2019,十+十一,機場,入境,34954,7386,8907,51247
29/9/2019,十+十一,機場,出境,27268,13238,16694,57200
29/9/2019,十+十一,高鐵西九龍,入境,9992,7110,999,18101
29/9/2019,十+十一,高鐵西九龍,出境,6630,4999,398,12027
29/9/2019,十+十一,紅磡,入境,1440,820,174,2434
29/9/2019,十+十一,紅磡,出境,772,360,90,1222
29/9/2019,十+十一,羅湖,入境,95657,18237,1078,114972
29/9/2019,十+十一,羅湖,出境,73850,18287,765,92902
29/9/2019,十+十一,落馬洲支線,入境,51058,16268,526,67852
29/9/2019,十+十一,落馬洲支線,出境,38219,13925,286,52430
29/9/2019,十+十一,港珠澳大橋,入境,22483,2501,2507,27491
29/9/2019,十+十一,港珠澳大橋,出境,16987,2656,2947,22590
29/9/2019,十+十一,落馬洲,入境,26914,6237,1387,34538
29/9/2019,十+十一,落馬洲,出境,17721,4519,329,22569
29/9/2019,十+十一,文錦渡,入境,1825,1273,73,3171
29/9/2019,十+十一,文錦渡,出境,1423,844,12,2279
29/9/2019,十+十一,沙頭角,入境,2864,726,137,3727
29/9/2019,十+十一,沙頭角,出境,2280,541,20,2841
29/9/2019,十+十一,深圳灣,入境,40043,14973,2073,57089
29/9/2019,十+十一,深圳灣,出境,26864,11326,598,38788
29/9/2019,十+十一,中國客運碼頭,入境,3476,495,545,4516
29/9/2019,十+十一,中國客運碼頭,出境,2290,649,473,3412
29/9/2019,十+十一,港口管制,入境,0,0,104,104
29/9/2019,十+十一,港口管制,出境,0,0,1,1
29/9/2019,十+十一,啟德郵輪碼頭,入境,3072,554,360,3986
29/9/2019,十+十一,啟德郵輪碼頭,出境,817,271,224,1312
29/9/2019,十+十一,港澳客輪碼頭,入境,12523,461,1582,14566
29/9/2019,十+十一,港澳客輪碼頭,出境,9423,372,1589,11384
29/9/2019,十+十一,屯門客運碼頭,入境,995,14,22,1031
29/9/2019,十+十一,屯門客運碼頭,出境,816,9,11,836
30/9/2019,十+十一,機場,入境,36897,9642,10027,56566
30/9/2019,十+十一,機場,出境,22038,23249,14243,59530
30/9/2019,十+十一,高鐵西九龍,入境,7970,11375,1251,20596
30/9/2019,十+十一,高鐵西九龍,出境,7288,5860,425,13573
30/9/2019,十+十一,紅磡,入境,1467,876,293,2636
30/9/2019,十+十一,紅磡,出境,1127,471,149,1747
30/9/2019,十+十一,羅湖,入境,74161,22699,1252,98112
30/9/2019,十+十一,羅湖,出境,83721,19538,776,104035
30/9/2019,十+十一,落馬洲支線,入境,44722,19699,662,65083
30/9/2019,十+十一,落馬洲支線,出境,47125,16097,339,63561
30/9/2019,十+十一,港珠澳大橋,入境,14185,3721,1911,19817
30/9/2019,十+十一,港珠澳大橋,出境,13936,2746,2024,18706
30/9/2019,十+十一,落馬洲,入境,22601,10208,1485,34294
30/9/2019,十+十一,落馬洲,出境,21005,5503,374,26882
30/9/2019,十+十一,文錦渡,入境,3273,1789,55,5117
30/9/2019,十+十一,文錦渡,出境,3649,1215,18,4882
30/9/2019,十+十一,沙頭角,入境,2662,961,150,3773
30/9/2019,十+十一,沙頭角,出境,3004,590,65,3659
30/9/2019,十+十一,深圳灣,入境,28068,21174,2188,51430
30/9/2019,十+十一,深圳灣,出境,28067,12279,728,41074
30/9/2019,十+十一,中國客運碼頭,入境,2481,1032,625,4138
30/9/2019,十+十一,中國客運碼頭,出境,2066,894,410,3370
30/9/2019,十+十一,港口管制,入境,1,0,52,53
30/9/2019,十+十一,港口管制,出境,1,5,34,40
30/9/2019,十+十一,啟德郵輪碼頭,入境,746,71,13,830
30/9/2019,十+十一,啟德郵輪碼頭,出境,881,57,155,1093
30/9/2019,十+十一,港澳客輪碼頭,入境,10403,668,1862,12933
30/9/2019,十+十一,港澳客輪碼頭,出境,10340,607,1674,12621
30/9/2019,十+十一,屯門客運碼頭,入境,791,7,21,819
30/9/2019,十+十一,屯門客運碼頭,出境,579,10,15,604
1/10/2019,十+十一,機場,入境,43552,8315,8491,60358
1/10/2019,十+十一,機場,出境,18262,25924,11451,55637
1/10/2019,十+十一,高鐵西九龍,入境,8901,14268,1132,24301
1/10/2019,十+十一,高鐵西九龍,出境,4163,4066,337,8566
1/10/2019,十+十一,紅磡,入境,994,792,190,1976
1/10/2019,十+十一,紅磡,出境,512,226,67,805
1/10/2019,十+十一,羅湖,入境,58762,18018,922,77702
1/10/2019,十+十一,羅湖,出境,43804,12018,516,56338
1/10/2019,十+十一,落馬洲支線,入境,32958,14635,523,48116
1/10/2019,十+十一,落馬洲支線,出境,24412,8420,212,33044
1/10/2019,十+十一,港珠澳大橋,入境,15153,4659,1513,21325
1/10/2019,十+十一,港珠澳大橋,出境,9617,3305,1502,14424
1/10/2019,十+十一,落馬洲,入境,20377,11156,1455,32988
1/10/2019,十+十一,落馬洲,出境,14011,4533,234,18778
1/10/2019,十+十一,文錦渡,入境,1336,1319,16,2671
1/10/2019,十+十一,文錦渡,出境,1020,516,5,1541
1/10/2019,十+十一,沙頭角,入境,1899,927,122,2948
1/10/2019,十+十一,沙頭角,出境,1341,331,20,1692
1/10/2019,十+十一,深圳灣,入境,20016,17093,1880,38989
1/10/2019,十+十一,深圳灣,出境,13196,5180,357,18733
1/10/2019,十+十一,中國客運碼頭,入境,2581,1264,591,4436
1/10/2019,十+十一,中國客運碼頭,出境,1089,755,479,2323
1/10/2019,十+十一,港口管制,入境,0,2,52,54
1/10/2019,十+十一,港口管制,出境,0,0,2,2
1/10/2019,十+十一,啟德郵輪碼頭,入境,878,57,5,940
1/10/2019,十+十一,啟德郵輪碼頭,出境,478,74,7,559
1/10/2019,十+十一,港澳客輪碼頭,入境,7192,574,1044,8810
1/10/2019,十+十一,港澳客輪碼頭,出境,3625,541,878,5044
1/10/2019,十+十一,屯門客運碼頭,入境,868,18,28,914
1/10/2019,十+十一,屯門客運碼頭,出境,419,15,15,449
2/10/2019,十+十一,機場,入境,33408,9835,12548,55791
2/10/2019,十+十一,機場,出境,21346,16219,10210,47775
2/10/2019,十+十一,高鐵西九龍,入境,8382,18996,1097,28475
2/10/2019,十+十一,高鐵西九龍,出境,4417,9348,545,14310
2/10/2019,十+十一,紅磡,入境,1056,1264,263,2583
2/10/2019,十+十一,紅磡,出境,810,508,129,1447
2/10/2019,十+十一,羅湖,入境,68924,27063,1066,97053
2/10/2019,十+十一,羅湖,出境,60010,25067,887,85964
2/10/2019,十+十一,落馬洲支線,入境,41903,25028,589,67520
2/10/2019,十+十一,落馬洲支線,出境,36506,18875,383,55764
2/10/2019,十+十一,港珠澳大橋,入境,11738,6961,1932,20631
2/10/2019,十+十一,港珠澳大橋,出境,9366,6846,2517,18729
2/10/2019,十+十一,落馬洲,入境,20013,10512,750,31275
2/10/2019,十+十一,落馬洲,出境,14100,5208,380,19688
2/10/2019,十+十一,文錦渡,入境,3664,1765,25,5454
2/10/2019,十+十一,文錦渡,出境,3553,1097,7,4657
2/10/2019,十+十一,沙頭角,入境,2554,1093,82,3729
2/10/2019,十+十一,沙頭角,出境,2349,577,40,2966
2/10/2019,十+十一,深圳灣,入境,25865,26784,1531,54180
2/10/2019,十+十一,深圳灣,出境,19986,17001,797,37784
2/10/2019,十+十一,中國客運碼頭,入境,1675,1708,507,3890
2/10/2019,十+十一,中國客運碼頭,出境,1139,1332,455,2926
2/10/2019,十+十一,港口管制,入境,1,0,64,65
2/10/2019,十+十一,港口管制,出境,1,0,19,20
2/10/2019,十+十一,啟德郵輪碼頭,入境,478,74,11,563
2/10/2019,十+十一,啟德郵輪碼頭,出境,744,112,11,867
2/10/2019,十+十一,港澳客輪碼頭,入境,6972,1261,2041,10274
2/10/2019,十+十一,港澳客輪碼頭,出境,6109,958,1802,8869
2/10/2019,十+十一,屯門客運碼頭,入境,370,13,6,389
2/10/2019,十+十一,屯門客運碼頭,出境,407,16,18,441
3/10/2019,十+十一,機場,入境,23436,12830,15228,51494
3/10/2019,十+十一,機場,出境,27518,9663,10216,47397
3/10/2019,十+十一,高鐵西九龍,入境,5545,15816,867,22228
3/10/2019,十+十一,高鐵西九龍,出境,5563,14132,898,20593
3/10/2019,十+十一,紅磡,入境,794,964,170,1928
3/10/2019,十+十一,紅磡,出境,818,1259,199,2276
3/10/2019,十+十一,羅湖,入境,64032,27943,971,92946
3/10/2019,十+十一,羅湖,出境,66371,30334,1174,97879
3/10/2019,十+十一,落馬洲支線,入境,39361,25104,534,64999
3/10/2019,十+十一,落馬洲支線,出境,39489,22654,623,62766
3/10/2019,十+十一,港珠澳大橋,入境,9788,7646,1391,18825
3/10/2019,十+十一,港珠澳大橋,出境,9868,9010,1858,20736
3/10/2019,十+十一,落馬洲,入境,17066,7989,494,25549
3/10/2019,十+十一,落馬洲,出境,15733,7485,682,23900
3/10/2019,十+十一,文錦渡,入境,3694,1989,32,5715
3/10/2019,十+十一,文錦渡,出境,3619,1331,19,4969
3/10/2019,十+十一,沙頭角,入境,2486,1024,71,3581
3/10/2019,十+十一,沙頭角,出境,2522,804,95,3421
3/10/2019,十+十一,深圳灣,入境,23465,23155,1071,47691
3/10/2019,十+十一,深圳灣,出境,23675,22479,1455,47609
3/10/2019,十+十一,中國客運碼頭,入境,1577,1829,571,3977
3/10/2019,十+十一,中國客運碼頭,出境,1531,2054,640,4225
3/10/2019,十+十一,港口管制,入境,0,0,219,219
3/10/2019,十+十一,港口管制,出境,0,0,4,4
3/10/2019,十+十一,啟德郵輪碼頭,入境,753,116,499,1368
3/10/2019,十+十一,啟德郵輪碼頭,出境,701,156,161,1018
3/10/2019,十+十一,港澳客輪碼頭,入境,6557,1349,1850,9756
3/10/2019,十+十一,港澳客輪碼頭,出境,6986,1271,1845,10102
3/10/2019,十+十一,屯門客運碼頭,入境,434,9,10,453
3/10/2019,十+十一,屯門客運碼頭,出境,524,8,8,540
4/10/2019,十+十一,機場,入境,23810,16666,14272,54748
4/10/2019,十+十一,機場,出境,47974,7796,10211,65981
4/10/2019,十+十一,高鐵西九龍,入境,4604,14112,623,19339
4/10/2019,十+十一,高鐵西九龍,出境,12854,16917,1114,30885
4/10/2019,十+十一,紅磡,入境,703,1180,154,2037
4/10/2019,十+十一,紅磡,出境,1951,1271,246,3468
4/10/2019,十+十一,羅湖,入境,60879,27228,909,89016
4/10/2019,十+十一,羅湖,出境,85453,30618,1197,117268
4/10/2019,十+十一,落馬洲支線,入境,38779,23642,446,62867
4/10/2019,十+十一,落馬洲支線,出境,48599,24114,672,73385
4/10/2019,十+十一,港珠澳大橋,入境,9855,6884,1783,18522
4/10/2019,十+十一,港珠澳大橋,出境,15135,9755,2045,26935
4/10/2019,十+十一,落馬洲,入境,20442,6470,372,27284
4/10/2019,十+十一,落馬洲,出境,23579,9965,965,34509
4/10/2019,十+十一,文錦渡,入境,3564,2139,14,5717
4/10/2019,十+十一,文錦渡,出境,3903,1553,69,5525
4/10/2019,十+十一,沙頭角,入境,2556,958,38,3552
4/10/2019,十+十一,沙頭角,出境,3240,956,89,4285
4/10/2019,十+十一,深圳灣,入境,22715,21703,833,45251
4/10/2019,十+十一,深圳灣,出境,34945,26553,1959,63457
4/10/2019,十+十一,中國客運碼頭,入境,1825,1941,699,4465
4/10/2019,十+十一,中國客運碼頭,出境,2539,2383,800,5722
4/10/2019,十+十一,港口管制,入境,1,0,83,84
4/10/2019,十+十一,港口管制,出境,1,0,41,42
4/10/2019,十+十一,啟德郵輪碼頭,入境,811,2201,73,3085
4/10/2019,十+十一,啟德郵輪碼頭,出境,2341,2538,873,5752
4/10/2019,十+十一,港澳客輪碼頭,入境,6804,1312,2150,10266
4/10/2019,十+十一,港澳客輪碼頭,出境,8460,1524,1968,11952
4/10/2019,十+十一,屯門客運碼頭,入境,560,28,18,606
4/10/2019,十+十一,屯門客運碼頭,出境,502,17,10,529
5/10/2019,十+十一,機場,入境,24119,20943,13675,58737
5/10/2019,十+十一,機場,出境,45474,8553,10611,64638
5/10/2019,十+十一,高鐵西九龍,入境,4268,6304,376,10948
5/10/2019,十+十一,高鐵西九龍,出境,23739,17435,1092,42266
5/10/2019,十+十一,紅磡,入境,2,0,0,2
5/10/2019,十+十一,紅磡,出境,0,0,0,0
5/10/2019,十+十一,羅湖,入境,414,6,3,423
5/10/2019,十+十一,羅湖,出境,508,22,4,534
5/10/2019,十+十一,落馬洲支線,入境,16081,8667,279,25027
5/10/2019,十+十一,落馬洲支線,出境,34622,10978,505,46105
5/10/2019,十+十一,港珠澳大橋,入境,9049,3939,1788,14776
5/10/2019,十+十一,港珠澳大橋,出境,25787,8584,2014,36385
5/10/2019,十+十一,落馬洲,入境,29629,6389,581,36599
5/10/2019,十+十一,落馬洲,出境,55967,19095,1709,76771
5/10/2019,十+十一,文錦渡,入境,5322,2166,91,7579
5/10/2019,十+十一,文錦渡,出境,9629,3236,126,12991
5/10/2019,十+十一,沙頭角,入境,1777,494,62,2333
5/10/2019,十+十一,沙頭角,出境,5323,1385,176,6884
5/10/2019,十+十一,深圳灣,入境,18224,10341,620,29185
5/10/2019,十+十一,深圳灣,出境,59900,27746,2574,90220
5/10/2019,十+十一,中國客運碼頭,入境,1525,887,622,3034
5/10/2019,十+十一,中國客運碼頭,出境,5189,2464,972,8625
5/10/2019,十+十一,港口管制,入境,0,0,41,41
5/10/2019,十+十一,港口管制,出境,7,1,0,8
5/10/2019,十+十一,啟德郵輪碼頭,入境,744,172,6,922
5/10/2019,十+十一,啟德郵輪碼頭,出境,803,78,2,883
5/10/2019,十+十一,港澳客輪碼頭,入境,5023,755,1600,7378
5/10/2019,十+十一,港澳客輪碼頭,出境,11314,1359,1823,14496
5/10/2019,十+十一,屯門客運碼頭,入境,449,11,35,495
5/10/2019,十+十一,屯門客運碼頭,出境,916,21,16,953
6/10/2019,十+十一,機場,入境,26678,28942,13253,68873
6/10/2019,十+十一,機場,出境,33739,10036,12880,56655
6/10/2019,十+十一,高鐵西九龍,入境,6458,2677,357,9492
6/10/2019,十+十一,高鐵西九龍,出境,10693,12223,1060,23976
6/10/2019,十+十一,紅磡,入境,368,157,77,602
6/10/2019,十+十一,紅磡,出境,1414,387,147,1948
6/10/2019,十+十一,羅湖,入境,30751,4637,404,35792
6/10/2019,十+十一,羅湖,出境,51284,7886,545,59715
6/10/2019,十+十一,落馬洲支線,入境,29918,8267,224,38409
6/10/2019,十+十一,落馬洲支線,出境,42954,11328,626,54908
6/10/2019,十+十一,港珠澳大橋,入境,16665,2806,1898,21369
6/10/2019,十+十一,港珠澳大橋,出境,23811,5391,2210,31412
6/10/2019,十+十一,落馬洲,入境,31141,3675,405,35221
6/10/2019,十+十一,落馬洲,出境,32722,15605,1987,50314
6/10/2019,十+十一,文錦渡,入境,4493,1421,23,5937
6/10/2019,十+十一,文錦渡,出境,6568,2348,81,8997
6/10/2019,十+十一,沙頭角,入境,2454,440,45,2939
6/10/2019,十+十一,沙頭角,出境,3046,997,238,4281
6/10/2019,十+十一,深圳灣,入境,31129,7946,501,39576
6/10/2019,十+十一,深圳灣,出境,42761,22980,3417,69158
6/10/2019,十+十一,中國客運碼頭,入境,2536,494,504,3534
6/10/2019,十+十一,中國客運碼頭,出境,3887,1118,895,5900
6/10/2019,十+十一,港口管制,入境,0,0,71,71
6/10/2019,十+十一,港口管制,出境,0,0,0,0
6/10/2019,十+十一,啟德郵輪碼頭,入境,2374,2441,117,4932
6/10/2019,十+十一,啟德郵輪碼頭,出境,1610,2129,148,3887
6/10/2019,十+十一,港澳客輪碼頭,入境,7694,604,1238,9536
6/10/2019,十+十一,港澳客輪碼頭,出境,10220,604,1305,12129
6/10/2019,十+十一,屯門客運碼頭,入境,903,17,27,947
6/10/2019,十+十一,屯門客運碼頭,出境,966,8,18,992
7/10/2019,十+十一,機場,入境,46464,29626,12379,88469
7/10/2019,十+十一,機場,出境,28561,8097,10192,46850
7/10/2019,十+十一,高鐵西九龍,入境,19922,2736,288,22946
7/10/2019,十+十一,高鐵西九龍,出境,5765,9487,1021,16273
7/10/2019,十+十一,紅磡,入境,0,0,0,0
7/10/2019,十+十一,紅磡,出境,0,0,0,0
7/10/2019,十+十一,羅湖,入境,59819,5910,350,66079
7/10/2019,十+十一,羅湖,出境,26459,6639,561,33659
7/10/2019,十+十一,落馬洲支線,入境,51746,9747,196,61689
7/10/2019,十+十一,落馬洲支線,出境,27817,10670,622,39109
7/10/2019,十+十一,港珠澳大橋,入境,35099,2126,1217,38442
7/10/2019,十+十一,港珠澳大橋,出境,11126,3556,2332,17014
7/10/2019,十+十一,落馬洲,入境,58906,4663,489,64058
7/10/2019,十+十一,落馬洲,出境,22568,15847,2048,40463
7/10/2019,十+十一,文錦渡,入境,9265,1967,46,11278
7/10/2019,十+十一,文錦渡,出境,4838,2317,120,7275
7/10/2019,十+十一,沙頭角,入境,5217,499,48,5764
7/10/2019,十+十一,沙頭角,出境,2172,858,166,3196
7/10/2019,十+十一,深圳灣,入境,72603,8429,623,81655
7/10/2019,十+十一,深圳灣,出境,23596,19528,2518,45642
7/10/2019,十+十一,中國客運碼頭,入境,6412,457,460,7329
7/10/2019,十+十一,中國客運碼頭,出境,1860,701,703,3264
7/10/2019,十+十一,港口管制,入境,4,0,51,55
7/10/2019,十+十一,港口管制,出境,1,0,8,9
7/10/2019,十+十一,啟德郵輪碼頭,入境,933,72,20,1025
7/10/2019,十+十一,啟德郵輪碼頭,出境,762,60,9,831
7/10/2019,十+十一,港澳客輪碼頭,入境,12763,430,948,14141
7/10/2019,十+十一,港澳客輪碼頭,出境,6404,384,1320,8108
7/10/2019,十+十一,屯門客運碼頭,入境,1370,11,8,1389
7/10/2019,十+十一,屯門客運碼頭,出境,565,5,21,591
21/12/2019,十二+一,機場,入境,34643,8904,17560,61107
21/12/2019,十二+一,機場,出境,71827,4102,11322,87251
21/12/2019,十二+一,高鐵西九龍,入境,6682,10099,780,17561
21/12/2019,十二+一,高鐵西九龍,出境,23786,10473,712,34971
21/12/2019,十二+一,紅磡,入境,780,504,106,1390
21/12/2019,十二+一,紅磡,出境,1920,539,95,2554
21/12/2019,十二+一,羅湖,入境,71035,23848,1079,95962
21/12/2019,十二+一,羅湖,出境,113282,26904,1105,141291
21/12/2019,十二+一,落馬洲支線,入境,37999,26556,563,65118
21/12/2019,十二+一,落馬洲支線,出境,56598,26377,498,83473
21/12/2019,十二+一,港珠澳大橋,入境,11033,2312,2995,16340
21/12/2019,十二+一,港珠澳大橋,出境,19361,4052,3567,26980
21/12/2019,十二+一,落馬洲,入境,22304,5833,855,28992
21/12/2019,十二+一,落馬洲,出境,27253,6852,622,34727
21/12/2019,十二+一,文錦渡,入境,1848,2208,19,4075
21/12/2019,十二+一,文錦渡,出境,2649,1676,41,4366
21/12/2019,十二+一,沙頭角,入境,2104,994,76,3174
21/12/2019,十二+一,沙頭角,出境,3564,830,60,4454
21/12/2019,十二+一,深圳灣,入境,24770,20023,1472,46265
21/12/2019,十二+一,深圳灣,出境,45349,21947,1210,68506
21/12/2019,十二+一,中國客運碼頭,入境,1905,781,592,3278
21/12/2019,十二+一,中國客運碼頭,出境,2836,957,505,4298
21/12/2019,十二+一,港口管制,入境,0,6,52,58
21/12/2019,十二+一,港口管制,出境,0,0,10,10
21/12/2019,十二+一,啟德郵輪碼頭,入境,450,3836,1729,6015
21/12/2019,十二+一,啟德郵輪碼頭,出境,1761,3834,2559,8154
21/12/2019,十二+一,港澳客輪碼頭,入境,7128,535,1911,9574
21/12/2019,十二+一,港澳客輪碼頭,出境,10445,602,2139,13186
21/12/2019,十二+一,屯門客運碼頭,入境,430,9,54,493
21/12/2019,十二+一,屯門客運碼頭,出境,536,9,22,567
22/12/2019,十二+一,機場,入境,37576,7477,16617,61670
22/12/2019,十二+一,機場,出境,60705,5050,13283,79038
22/12/2019,十二+一,高鐵西九龍,入境,9440,5087,635,15162
22/12/2019,十二+一,高鐵西九龍,出境,14174,7518,824,22516
22/12/2019,十二+一,紅磡,入境,1120,205,86,1411
22/12/2019,十二+一,紅磡,出境,1084,404,130,1618
22/12/2019,十二+一,羅湖,入境,85117,14791,992,100900
22/12/2019,十二+一,羅湖,出境,75786,18687,1104,95577
22/12/2019,十二+一,落馬洲支線,入境,43899,18625,493,63017
22/12/2019,十二+一,落馬洲支線,出境,42036,19497,609,62142
22/12/2019,十二+一,港珠澳大橋,入境,16287,1742,3228,21257
22/12/2019,十二+一,港珠澳大橋,出境,19028,3567,3896,26491
22/12/2019,十二+一,落馬洲,入境,25770,4771,602,31143
22/12/2019,十二+一,落馬洲,出境,20477,5491,817,26785
22/12/2019,十二+一,文錦渡,入境,1983,1284,22,3289
22/12/2019,十二+一,文錦渡,出境,1707,1014,17,2738
22/12/2019,十二+一,沙頭角,入境,2466,441,65,2972
22/12/2019,十二+一,沙頭角,出境,2193,527,104,2824
22/12/2019,十二+一,深圳灣,入境,32317,11368,985,44670
22/12/2019,十二+一,深圳灣,出境,33036,14605,1335,48976
22/12/2019,十二+一,中國客運碼頭,入境,2327,390,610,3327
22/12/2019,十二+一,中國客運碼頭,出境,2676,699,783,4158
22/12/2019,十二+一,港口管制,入境,0,0,236,236
22/12/2019,十二+一,港口管制,出境,1,0,29,30
22/12/2019,十二+一,啟德郵輪碼頭,入境,5183,1809,611,7603
22/12/2019,十二+一,啟德郵輪碼頭,出境,4784,480,2321,7585
22/12/2019,十二+一,港澳客輪碼頭,入境,9396,356,1698,11450
22/12/2019,十二+一,港澳客輪碼頭,出境,10520,402,2120,13042
22/12/2019,十二+一,屯門客運碼頭,入境,567,12,41,620
22/12/2019,十二+一,屯門客運碼頭,出境,880,7,42,929
23/12/2019,十二+一,機場,入境,33497,7607,18021,59125
23/12/2019,十二+一,機場,出境,56357,4638,13002,73997
23/12/2019,十二+一,高鐵西九龍,入境,10265,9172,748,20185
23/12/2019,十二+一,高鐵西九龍,出境,15718,8189,819,24726
23/12/2019,十二+一,紅磡,入境,984,586,141,1711
23/12/2019,十二+一,紅磡,出境,1907,481,125,2513
23/12/2019,十二+一,羅湖,入境,77776,21056,1046,99878
23/12/2019,十二+一,羅湖,出境,90938,21086,1262,113286
23/12/2019,十二+一,落馬洲支線,入境,41186,17199,485,58870
23/12/2019,十二+一,落馬洲支線,出境,47320,15521,567,63408
23/12/2019,十二+一,港珠澳大橋,入境,15907,2760,4447,23114
23/12/2019,十二+一,港珠澳大橋,出境,21581,3677,4985,30243
23/12/2019,十二+一,落馬洲,入境,23263,7067,557,30887
23/12/2019,十二+一,落馬洲,出境,22838,7262,841,30941
23/12/2019,十二+一,文錦渡,入境,1967,1655,35,3657
23/12/2019,十二+一,文錦渡,出境,2227,1403,22,3652
23/12/2019,十二+一,沙頭角,入境,2118,746,63,2927
23/12/2019,十二+一,沙頭角,出境,2668,571,92,3331
23/12/2019,十二+一,深圳灣,入境,27281,14523,1110,42914
23/12/2019,十二+一,深圳灣,出境,36560,13958,1472,51990
23/12/2019,十二+一,中國客運碼頭,入境,2887,1088,884,4859
23/12/2019,十二+一,中國客運碼頭,出境,3181,823,872,4876
23/12/2019,十二+一,港口管制,入境,1,0,33,34
23/12/2019,十二+一,港口管制,出境,1,0,22,23
23/12/2019,十二+一,啟德郵輪碼頭,入境,378,26,21,425
23/12/2019,十二+一,啟德郵輪碼頭,出境,685,50,16,751
23/12/2019,十二+一,港澳客輪碼頭,入境,9857,608,2750,13215
23/12/2019,十二+一,港澳客輪碼頭,出境,11425,655,2696,14776
23/12/2019,十二+一,屯門客運碼頭,入境,841,3,45,889
23/12/2019,十二+一,屯門客運碼頭,出境,819,6,27,852
24/12/2019,十二+一,機場,入境,31465,5541,17399,54405
24/12/2019,十二+一,機場,出境,61634,3685,9656,74975
24/12/2019,十二+一,高鐵西九龍,入境,8014,8152,597,16763
24/12/2019,十二+一,高鐵西九龍,出境,23669,7677,731,32077
24/12/2019,十二+一,紅磡,入境,825,472,115,1412
24/12/2019,十二+一,紅磡,出境,2090,448,126,2664
24/12/2019,十二+一,羅湖,入境,67387,20568,889,88844
24/12/2019,十二+一,羅湖,出境,114915,21854,1063,137832
24/12/2019,十二+一,落馬洲支線,入境,36892,16518,506,53916
24/12/2019,十二+一,落馬洲支線,出境,53395,15512,445,69352
24/12/2019,十二+一,港珠澳大橋,入境,15468,2342,3526,21336
24/12/2019,十二+一,港珠澳大橋,出境,28661,3340,5226,37227
24/12/2019,十二+一,落馬洲,入境,20887,5102,531,26520
24/12/2019,十二+一,落馬洲,出境,27621,6321,686,34628
24/12/2019,十二+一,文錦渡,入境,1829,1692,21,3542
24/12/2019,十二+一,文錦渡,出境,2360,1144,15,3519
24/12/2019,十二+一,沙頭角,入境,1832,639,79,2550
24/12/2019,十二+一,沙頭角,出境,3098,584,85,3767
24/12/2019,十二+一,深圳灣,入境,23872,12925,902,37699
24/12/2019,十二+一,深圳灣,出境,44284,13095,1116,58495
24/12/2019,十二+一,中國客運碼頭,入境,2249,871,682,3802
24/12/2019,十二+一,中國客運碼頭,出境,3712,858,625,5195
24/12/2019,十二+一,港口管制,入境,2,0,40,42
24/12/2019,十二+一,港口管制,出境,2,0,5,7
24/12/2019,十二+一,啟德郵輪碼頭,入境,683,50,4,737
24/12/2019,十二+一,啟德郵輪碼頭,出境,902,129,9,1040
24/12/2019,十二+一,港澳客輪碼頭,入境,9469,523,2142,12134
24/12/2019,十二+一,港澳客輪碼頭,出境,13243,648,2144,16035
24/12/2019,十二+一,屯門客運碼頭,入境,677,9,24,710
24/12/2019,十二+一,屯門客運碼頭,出境,639,11,17,667
25/12/2019,十二+一,機場,入境,36967,4956,18860,60783
25/12/2019,十二+一,機場,出境,58138,3320,10775,72233
25/12/2019,十二+一,高鐵西九龍,入境,8799,4560,519,13878
25/12/2019,十二+一,高鐵西九龍,出境,25300,5777,651,31728
25/12/2019,十二+一,紅磡,入境,800,300,69,1169
25/12/2019,十二+一,紅磡,出境,2442,370,100,2912
25/12/2019,十二+一,羅湖,入境,86038,15714,758,102510
25/12/2019,十二+一,羅湖,出境,127625,18443,978,147046
25/12/2019,十二+一,落馬洲支線,入境,47218,13181,356,60755
25/12/2019,十二+一,落馬洲支線,出境,71808,12867,394,85069
25/12/2019,十二+一,港珠澳大橋,入境,26409,2046,2792,31247
25/12/2019,十二+一,港珠澳大橋,出境,49763,3351,6794,59908
25/12/2019,十二+一,落馬洲,入境,25269,4067,473,29809
25/12/2019,十二+一,落馬洲,出境,29031,4960,602,34593
25/12/2019,十二+一,文錦渡,入境,1629,1351,37,3017
25/12/2019,十二+一,文錦渡,出境,2365,861,27,3253
25/12/2019,十二+一,沙頭角,入境,2030,405,50,2485
25/12/2019,十二+一,沙頭角,出境,3606,373,73,4052
25/12/2019,十二+一,深圳灣,入境,31012,8648,829,40489
25/12/2019,十二+一,深圳灣,出境,59558,10070,1025,70653
25/12/2019,十二+一,中國客運碼頭,入境,2350,466,534,3350
25/12/2019,十二+一,中國客運碼頭,出境,5931,672,615,7218
25/12/2019,十二+一,港口管制,入境,1,0,21,22
25/12/2019,十二+一,港口管制,出境,0,0,0,0
25/12/2019,十二+一,啟德郵輪碼頭,入境,909,129,2404,3442
25/12/2019,十二+一,啟德郵輪碼頭,出境,877,116,13,1006
25/12/2019,十二+一,港澳客輪碼頭,入境,10364,467,1531,12362
25/12/2019,十二+一,港澳客輪碼頭,出境,16498,507,1940,18945
25/12/2019,十二+一,屯門客運碼頭,入境,827,5,11,843
25/12/2019,十二+一,屯門客運碼頭,出境,1135,10,41,1186
26/12/2019,十二+一,機場,入境,47191,4930,18714,70835
26/12/2019,十二+一,機場,出境,44335,3702,15898,63935
26/12/2019,十二+一,高鐵西九龍,入境,20703,5179,558,26440
26/12/2019,十二+一,高鐵西九龍,出境,12172,4967,706,17845
26/12/2019,十二+一,紅磡,入境,2123,424,99,2646
26/12/2019,十二+一,紅磡,出境,1212,352,78,1642
26/12/2019,十二+一,羅湖,入境,127800,15591,942,144333
26/12/2019,十二+一,羅湖,出境,74553,16564,958,92075
26/12/2019,十二+一,落馬洲支線,入境,63499,12940,367,76806
26/12/2019,十二+一,落馬洲支線,出境,41502,12009,306,53817
26/12/2019,十二+一,港珠澳大橋,入境,44041,2555,3033,49629
26/12/2019,十二+一,港珠澳大橋,出境,24603,3303,4483,32389
26/12/2019,十二+一,落馬洲,入境,33190,4136,664,37990
26/12/2019,十二+一,落馬洲,出境,19241,3904,559,23704
26/12/2019,十二+一,文錦渡,入境,2232,1350,31,3613
26/12/2019,十二+一,文錦渡,出境,1588,873,14,2475
26/12/2019,十二+一,沙頭角,入境,3462,529,63,4054
26/12/2019,十二+一,沙頭角,出境,2089,423,63,2575
26/12/2019,十二+一,深圳灣,入境,60585,9914,896,71395
26/12/2019,十二+一,深圳灣,出境,28698,9537,775,39010
26/12/2019,十二+一,中國客運碼頭,入境,5799,522,650,6971
26/12/2019,十二+一,中國客運碼頭,出境,3193,705,961,4859
26/12/2019,十二+一,港口管制,入境,0,0,38,38
26/12/2019,十二+一,港口管制,出境,0,0,1,1
26/12/2019,十二+一,啟德郵輪碼頭,入境,2306,116,35,2457
26/12/2019,十二+一,啟德郵輪碼頭,出境,721,97,43,861
26/12/2019,十二+一,港澳客輪碼頭,入境,17409,479,1761,19649
26/12/2019,十二+一,港澳客輪碼頭,出境,10869,512,2194,13575
26/12/2019,十二+一,屯門客運碼頭,入境,1328,14,18,1360
26/12/2019,十二+一,屯門客運碼頭,出境,796,7,20,823
27/12/2019,十二+一,機場,入境,45092,5647,18949,69688
27/12/2019,十二+一,機場,出境,49396,4516,14751,68663
27/12/2019,十二+一,高鐵西九龍,入境,14835,8725,841,24401
27/12/2019,十二+一,高鐵西九龍,出境,12321,7451,750,20522
27/12/2019,十二+一,紅磡,入境,1542,543,146,2231
27/12/2019,十二+一,紅磡,出境,1649,489,118,2256
27/12/2019,十二+一,羅湖,入境,85184,21214,1186,107584
27/12/2019,十二+一,羅湖,出境,79766,21496,1134,102396
27/12/2019,十二+一,落馬洲支線,入境,46481,17890,568,64939
27/12/2019,十二+一,落馬洲支線,出境,41750,15756,445,57951
27/12/2019,十二+一,港珠澳大橋,入境,24533,2497,3201,30231
27/12/2019,十二+一,港珠澳大橋,出境,20652,4257,4372,29281
27/12/2019,十二+一,落馬洲,入境,26181,6465,901,33547
27/12/2019,十二+一,落馬洲,出境,20659,5319,617,26595
27/12/2019,十二+一,文錦渡,入境,2263,1678,21,3962
27/12/2019,十二+一,文錦渡,出境,1981,1122,25,3128
27/12/2019,十二+一,沙頭角,入境,2487,674,103,3264
27/12/2019,十二+一,沙頭角,出境,2174,548,59,2781
27/12/2019,十二+一,深圳灣,入境,35323,14629,1374,51326
27/12/2019,十二+一,深圳灣,出境,30441,13317,1027,44785
27/12/2019,十二+一,中國客運碼頭,入境,3946,849,1033,5828
27/12/2019,十二+一,中國客運碼頭,出境,2715,876,955,4546
27/12/2019,十二+一,港口管制,入境,0,0,227,227
27/12/2019,十二+一,港口管制,出境,6,0,15,21
27/12/2019,十二+一,啟德郵輪碼頭,入境,2386,313,171,2870
27/12/2019,十二+一,啟德郵輪碼頭,出境,3367,360,3102,6829
27/12/2019,十二+一,港澳客輪碼頭,入境,13405,621,2919,16945
27/12/2019,十二+一,港澳客輪碼頭,出境,11577,629,2886,15092
27/12/2019,十二+一,屯門客運碼頭,入境,902,10,25,937
27/12/2019,十二+一,屯門客運碼頭,出境,756,5,26,787
28/12/2019,十二+一,機場,入境,52705,5088,20784,78577
28/12/2019,十二+一,機場,出境,39197,5306,15715,60218
28/12/2019,十二+一,高鐵西九龍,入境,14703,9205,897,24805
28/12/2019,十二+一,高鐵西九龍,出境,11581,8326,733,20640
28/12/2019,十二+一,紅磡,入境,1355,377,128,1860
28/12/2019,十二+一,紅磡,出境,1306,382,106,1794
28/12/2019,十二+一,羅湖,入境,78697,22234,1356,102287
28/12/2019,十二+一,羅湖,出境,93192,24405,1087,118684
28/12/2019,十二+一,落馬洲支線,入境,44287,27320,516,72123
28/12/2019,十二+一,落馬洲支線,出境,49172,26015,444,75631
28/12/2019,十二+一,港珠澳大橋,入境,23282,2729,3736,29747
28/12/2019,十二+一,港珠澳大橋,出境,23640,4086,4911,32637
28/12/2019,十二+一,落馬洲,入境,23586,6926,847,31359
28/12/2019,十二+一,落馬洲,出境,22954,5235,581,28770
28/12/2019,十二+一,文錦渡,入境,1984,2189,12,4185
28/12/2019,十二+一,文錦渡,出境,2097,1643,35,3775
28/12/2019,十二+一,沙頭角,入境,2131,750,76,2957
28/12/2019,十二+一,沙頭角,出境,2372,635,38,3045
28/12/2019,十二+一,深圳灣,入境,32617,20750,1308,54675
28/12/2019,十二+一,深圳灣,出境,35882,19865,1069,56816
28/12/2019,十二+一,中國客運碼頭,入境,3295,763,1157,5215
28/12/2019,十二+一,中國客運碼頭,出境,3145,747,949,4841
28/12/2019,十二+一,港口管制,入境,0,0,44,44
28/12/2019,十二+一,港口管制,出境,0,0,16,16
28/12/2019,十二+一,啟德郵輪碼頭,入境,214,4118,52,4384
28/12/2019,十二+一,啟德郵輪碼頭,出境,212,4115,54,4381
28/12/2019,十二+一,港澳客輪碼頭,入境,11983,469,3065,15517
28/12/2019,十二+一,港澳客輪碼頭,出境,12632,578,2740,15950
28/12/2019,十二+一,屯門客運碼頭,入境,753,16,35,804
28/12/2019,十二+一,屯門客運碼頭,出境,709,10,30,749
29/12/2019,十二+一,機場,入境,68857,4043,15071,87971
29/12/2019,十二+一,機場,出境,34214,5197,18618,58029
29/12/2019,十二+一,高鐵西九龍,入境,21898,6316,807,29021
29/12/2019,十二+一,高鐵西九龍,出境,7820,7210,714,15744
29/12/2019,十二+一,紅磡,入境,2361,270,126,2757
29/12/2019,十二+一,紅磡,出境,909,565,130,1604
29/12/2019,十二+一,羅湖,入境,105272,17421,1284,123977
29/12/2019,十二+一,羅湖,出境,68849,20296,1133,90278
29/12/2019,十二+一,落馬洲支線,入境,52506,21017,465,73988
29/12/2019,十二+一,落馬洲支線,出境,36680,21319,420,58419
29/12/2019,十二+一,港珠澳大橋,入境,28882,2493,3261,34636
29/12/2019,十二+一,港珠澳大橋,出境,18039,5016,4424,27479
29/12/2019,十二+一,落馬洲,入境,28831,5042,705,34578
29/12/2019,十二+一,落馬洲,出境,17354,4405,471,22230
29/12/2019,十二+一,文錦渡,入境,2185,1533,24,3742
29/12/2019,十二+一,文錦渡,出境,1325,1004,22,2351
29/12/2019,十二+一,沙頭角,入境,2883,562,75,3520
29/12/2019,十二+一,沙頭角,出境,1713,567,48,2328
29/12/2019,十二+一,深圳灣,入境,52401,14520,1147,68068
29/12/2019,十二+一,深圳灣,出境,27509,16198,846,44553
29/12/2019,十二+一,中國客運碼頭,入境,3841,557,986,5384
29/12/2019,十二+一,中國客運碼頭,出境,1933,703,1116,3752
29/12/2019,十二+一,港口管制,入境,0,0,205,205
29/12/2019,十二+一,港口管制,出境,0,0,1,1
29/12/2019,十二+一,啟德郵輪碼頭,入境,5895,628,2230,8753
29/12/2019,十二+一,啟德郵輪碼頭,出境,3296,706,2560,6562
29/12/2019,十二+一,港澳客輪碼頭,入境,13038,440,2626,16104
29/12/2019,十二+一,港澳客輪碼頭,出境,9147,416,2774,12337
29/12/2019,十二+一,屯門客運碼頭,入境,837,9,25,871
29/12/2019,十二+一,屯門客運碼頭,出境,587,0,24,611
30/12/2019,十二+一,機場,入境,58966,4999,18078,82043
30/12/2019,十二+一,機場,出境,27989,4963,17085,50037
30/12/2019,十二+一,高鐵西九龍,入境,15359,8155,1052,24566
30/12/2019,十二+一,高鐵西九龍,出境,8018,7427,730,16175
30/12/2019,十二+一,紅磡,入境,1426,490,178,2094
30/12/2019,十二+一,紅磡,出境,1281,512,113,1906
30/12/2019,十二+一,羅湖,入境,86161,19281,1275,106717
30/12/2019,十二+一,羅湖,出境,76290,19184,1191,96665
30/12/2019,十二+一,落馬洲支線,入境,44897,16618,483,61998
30/12/2019,十二+一,落馬洲支線,出境,39914,14679,475,55068
30/12/2019,十二+一,港珠澳大橋,入境,18713,2268,3760,24741
30/12/2019,十二+一,港珠澳大橋,出境,15315,3596,4501,23412
30/12/2019,十二+一,落馬洲,入境,25832,8104,599,34535
30/12/2019,十二+一,落馬洲,出境,20952,5759,524,27235
30/12/2019,十二+一,文錦渡,入境,2256,1712,12,3980
30/12/2019,十二+一,文錦渡,出境,1867,1061,12,2940
30/12/2019,十二+一,沙頭角,入境,2373,653,66,3092
30/12/2019,十二+一,沙頭角,出境,2283,521,69,2873
30/12/2019,十二+一,深圳灣,入境,36863,13269,1294,51426
30/12/2019,十二+一,深圳灣,出境,26718,12663,1011,40392
30/12/2019,十二+一,中國客運碼頭,入境,3032,977,1338,5347
30/12/2019,十二+一,中國客運碼頭,出境,2359,902,1093,4354
30/12/2019,十二+一,港口管制,入境,0,0,40,40
30/12/2019,十二+一,港口管制,出境,1,0,1,2
30/12/2019,十二+一,啟德郵輪碼頭,入境,555,57,2867,3479
30/12/2019,十二+一,啟德郵輪碼頭,出境,486,59,26,571
30/12/2019,十二+一,港澳客輪碼頭,入境,10498,567,3302,14367
30/12/2019,十二+一,港澳客輪碼頭,出境,9942,543,2983,13468
30/12/2019,十二+一,屯門客運碼頭,入境,626,5,30,661
30/12/2019,十二+一,屯門客運碼頭,出境,601,4,23,628
31/12/2019,十二+一,機場,入境,58757,4109,14087,76953
31/12/2019,十二+一,機場,出境,26654,5183,14984,46821
31/12/2019,十二+一,高鐵西九龍,入境,13602,7453,1188,22243
31/12/2019,十二+一,高鐵西九龍,出境,9502,6318,502,16322
31/12/2019,十二+一,紅磡,入境,1528,467,162,2157
31/12/2019,十二+一,紅磡,出境,1026,420,115,1561
31/12/2019,十二+一,羅湖,入境,79480,19271,1102,99853
31/12/2019,十二+一,羅湖,出境,86505,19042,816,106363
31/12/2019,十二+一,落馬洲支線,入境,43113,16921,494,60528
31/12/2019,十二+一,落馬洲支線,出境,45852,14823,331,61006
31/12/2019,十二+一,港珠澳大橋,入境,15091,2265,2835,20191
31/12/2019,十二+一,港珠澳大橋,出境,16844,3196,3347,23387
31/12/2019,十二+一,落馬洲,入境,22789,5464,724,28977
31/12/2019,十二+一,落馬洲,出境,24429,4928,410,29767
31/12/2019,十二+一,文錦渡,入境,2075,1388,27,3490
31/12/2019,十二+一,文錦渡,出境,2063,973,14,3050
31/12/2019,十二+一,沙頭角,入境,2426,652,102,3180
31/12/2019,十二+一,沙頭角,出境,2196,505,48,2749
31/12/2019,十二+一,深圳灣,入境,34406,13059,1128,48593
31/12/2019,十二+一,深圳灣,出境,27484,11880,776,40140
31/12/2019,十二+一,中國客運碼頭,入境,2507,649,889,4045
31/12/2019,十二+一,中國客運碼頭,出境,2055,767,780,3602
31/12/2019,十二+一,港口管制,入境,31,0,63,94
31/12/2019,十二+一,港口管制,出境,0,0,3,3
31/12/2019,十二+一,啟德郵輪碼頭,入境,482,55,1559,2096
31/12/2019,十二+一,啟德郵輪碼頭,出境,1101,94,2850,4045
31/12/2019,十二+一,港澳客輪碼頭,入境,8645,480,2471,11596
31/12/2019,十二+一,港澳客輪碼頭,出境,10108,567,2221,12896
31/12/2019,十二+一,屯門客運碼頭,入境,536,7,27,570
31/12/2019,十二+一,屯門客運碼頭,出境,558,5,14,577
1/1/2020,十二+一,機場,入境,66624,3733,11409,81766
1/1/2020,十二+一,機場,出境,28618,4677,19370,52665
1/1/2020,十二+一,高鐵西九龍,入境,15040,6781,558,22379
1/1/2020,十二+一,高鐵西九龍,出境,5699,7106,917,13722
1/1/2020,十二+一,紅磡,入境,1262,272,82,1616
1/1/2020,十二+一,紅磡,出境,521,312,127,960
1/1/2020,十二+一,羅湖,入境,89085,18772,820,108677
1/1/2020,十二+一,羅湖,出境,60030,20727,906,81663
1/1/2020,十二+一,落馬洲支線,入境,47703,20848,386,68937
1/1/2020,十二+一,落馬洲支線,出境,33278,19336,488,53102
1/1/2020,十二+一,港珠澳大橋,入境,22679,2560,3541,28780
1/1/2020,十二+一,港珠澳大橋,出境,13922,4611,3923,22456
1/1/2020,十二+一,落馬洲,入境,28570,4410,465,33445
1/1/2020,十二+一,落馬洲,出境,16541,4677,614,21832
1/1/2020,十二+一,文錦渡,入境,1937,1335,15,3287
1/1/2020,十二+一,文錦渡,出境,1373,916,6,2295
1/1/2020,十二+一,沙頭角,入境,2285,543,51,2879
1/1/2020,十二+一,沙頭角,出境,1413,471,63,1947
1/1/2020,十二+一,深圳灣,入境,38549,13755,848,53152
1/1/2020,十二+一,深圳灣,出境,21240,13247,1000,35487
1/1/2020,十二+一,中國客運碼頭,入境,2556,421,737,3714
1/1/2020,十二+一,中國客運碼頭,出境,1242,566,923,2731
1/1/2020,十二+一,港口管制,入境,1,0,24,25
1/1/2020,十二+一,港口管制,出境,0,0,14,14
1/1/2020,十二+一,啟德郵輪碼頭,入境,1081,79,16,1176
1/1/2020,十二+一,啟德郵輪碼頭,出境,476,77,26,579
1/1/2020,十二+一,港澳客輪碼頭,入境,8883,505,1904,11292
1/1/2020,十二+一,港澳客輪碼頭,出境,5755,414,2015,8184
1/1/2020,十二+一,屯門客運碼頭,入境,686,10,23,719
1/1/2020,十二+一,屯門客運碼頭,出境,436,5,19,460
24/1/2020,二,機場,入境,20724,9124,14116,43964
24/1/2020,二,機場,出境,74876,4451,7242,86569
24/1/2020,二,高鐵西九龍,入境,1717,2380,337,4434
24/1/2020,二,高鐵西九龍,出境,20096,2800,316,23212
24/1/2020,二,紅磡,入境,433,470,71,974
24/1/2020,二,紅磡,出境,3498,194,51,3743
24/1/2020,二,羅湖,入境,26340,7383,429,34152
24/1/2020,二,羅湖,出境,72074,6231,413,78718
24/1/2020,二,落馬洲支線,入境,16750,4979,196,21925
24/1/2020,二,落馬洲支線,出境,32215,3766,167,36148
24/1/2020,二,港珠澳大橋,入境,7294,1949,2130,11373
24/1/2020,二,港珠澳大橋,出境,15775,2804,2086,20665
24/1/2020,二,落馬洲,入境,10591,2921,407,13919
24/1/2020,二,落馬洲,出境,17682,3901,283,21866
24/1/2020,二,文錦渡,入境,1093,367,9,1469
24/1/2020,二,文錦渡,出境,1890,219,9,2118
24/1/2020,二,沙頭角,入境,1008,264,27,1299
24/1/2020,二,沙頭角,出境,3207,210,40,3457
24/1/2020,二,深圳灣,入境,8792,5354,685,14831
24/1/2020,二,深圳灣,出境,37864,5142,484,43490
24/1/2020,二,中國客運碼頭,入境,1013,442,373,1828
24/1/2020,二,中國客運碼頭,出境,3511,453,312,4276
24/1/2020,二,港口管制,入境,7,0,259,266
24/1/2020,二,港口管制,出境,77,0,4,81
24/1/2020,二,啟德郵輪碼頭,入境,466,707,2400,3573
24/1/2020,二,啟德郵輪碼頭,出境,2487,775,280,3542
24/1/2020,二,港澳客輪碼頭,入境,6001,358,1395,7754
24/1/2020,二,港澳客輪碼頭,出境,8985,390,1314,10689
24/1/2020,二,屯門客運碼頭,入境,434,7,38,479
24/1/2020,二,屯門客運碼頭,出境,548,4,17,569
25/1/2020,二,機場,入境,14907,8489,10953,34349
25/1/2020,二,機場,出境,58711,5326,7335,71372
25/1/2020,二,高鐵西九龍,入境,1852,2278,285,4415
25/1/2020,二,高鐵西九龍,出境,8489,2089,224,10802
25/1/2020,二,紅磡,入境,575,176,67,818
25/1/2020,二,紅磡,出境,1509,153,53,1715
25/1/2020,二,羅湖,入境,20716,4368,317,25401
25/1/2020,二,羅湖,出境,39692,5468,347,45507
25/1/2020,二,落馬洲支線,入境,12511,3237,117,15865
25/1/2020,二,落馬洲支線,出境,16675,3347,155,20177
25/1/2020,二,港珠澳大橋,入境,9121,2682,2339,14142
25/1/2020,二,港珠澳大橋,出境,13570,2949,1830,18349
25/1/2020,二,落馬洲,入境,7187,2662,234,10083
25/1/2020,二,落馬洲,出境,10351,3163,195,13709
25/1/2020,二,文錦渡,入境,753,262,12,1027
25/1/2020,二,文錦渡,出境,895,203,5,1103
25/1/2020,二,沙頭角,入境,923,208,19,1150
25/1/2020,二,沙頭角,出境,1702,165,38,1905
25/1/2020,二,深圳灣,入境,9834,4540,532,14906
25/1/2020,二,深圳灣,出境,20440,4993,451,25884
25/1/2020,二,中國客運碼頭,入境,1183,463,499,2145
25/1/2020,二,中國客運碼頭,出境,2233,406,415,3054
25/1/2020,二,港口管制,入境,2,0,89,91
25/1/2020,二,港口管制,出境,2,0,2,4
25/1/2020,二,啟德郵輪碼頭,入境,168,25,2315,2508
25/1/2020,二,啟德郵輪碼頭,出境,2997,129,2521,5647
25/1/2020,二,港澳客輪碼頭,入境,6118,490,1355,7963
25/1/2020,二,港澳客輪碼頭,出境,8120,378,1048,9546
25/1/2020,二,屯門客運碼頭,入境,567,11,44,622
25/1/2020,二,屯門客運碼頭,出境,782,19,14,815
26/1/2020,二,機場,入境,22646,10955,7522,41123
26/1/2020,二,機場,出境,47580,7870,8813,64263
26/1/2020,二,高鐵西九龍,入境,7481,2481,415,10377
26/1/2020,二,高鐵西九龍,出境,2360,2875,300,5535
26/1/2020,二,紅磡,入境,2237,272,137,2646
26/1/2020,二,紅磡,出境,575,307,54,936
26/1/2020,二,羅湖,入境,44781,4994,406,50181
26/1/2020,二,羅湖,出境,22105,6754,348,29207
26/1/2020,二,落馬洲支線,入境,19606,3816,265,23687
26/1/2020,二,落馬洲支線,出境,10678,4376,226,15280
26/1/2020,二,港珠澳大橋,入境,12967,2486,2311,17764
26/1/2020,二,港珠澳大橋,出境,10182,3053,2082,15317
26/1/2020,二,落馬洲,入境,10754,3119,362,14235
26/1/2020,二,落馬洲,出境,7058,3642,240,10940
26/1/2020,二,文錦渡,入境,1093,345,24,1462
26/1/2020,二,文錦渡,出境,709,324,5,1038
26/1/2020,二,沙頭角,入境,2077,284,40,2401
26/1/2020,二,沙頭角,出境,1058,312,48,1418
26/1/2020,二,深圳灣,入境,26235,6051,868,33154
26/1/2020,二,深圳灣,出境,9524,7404,529,17457
26/1/2020,二,中國客運碼頭,入境,2418,522,501,3441
26/1/2020,二,中國客運碼頭,出境,1391,603,504,2498
26/1/2020,二,港口管制,入境,0,0,256,256
26/1/2020,二,港口管制,出境,0,0,0,0
26/1/2020,二,啟德郵輪碼頭,入境,2510,806,2251,5567
26/1/2020,二,啟德郵輪碼頭,出境,1000,394,317,1711
26/1/2020,二,港澳客輪碼頭,入境,8216,554,1325,10095
26/1/2020,二,港澳客輪碼頭,出境,6571,379,1284,8234
26/1/2020,二,屯門客運碼頭,入境,647,5,24,676
26/1/2020,二,屯門客運碼頭,出境,605,7,28,640
27/1/2020,二,機場,入境,36215,10309,6764,53288
27/1/2020,二,機場,出境,41316,8203,11319,60838
27/1/2020,二,高鐵西九龍,入境,10913,1887,421,13221
27/1/2020,二,高鐵西九龍,出境,1167,2790,246,4203
27/1/2020,二,紅磡,入境,2025,221,116,2362
27/1/2020,二,紅磡,出境,244,308,54,606
27/1/2020,二,羅湖,入境,43145,3643,387,47175
27/1/2020,二,羅湖,出境,13999,5193,387,19579
27/1/2020,二,落馬洲支線,入境,17463,2863,203,20529
27/1/2020,二,落馬洲支線,出境,7787,3592,175,11554
27/1/2020,二,港珠澳大橋,入境,14306,1998,1998,18302
27/1/2020,二,港珠澳大橋,出境,7369,2822,2088,12279
27/1/2020,二,落馬洲,入境,10708,1945,356,13009
27/1/2020,二,落馬洲,出境,5174,3655,233,9062
27/1/2020,二,文錦渡,入境,1280,281,12,1573
27/1/2020,二,文錦渡,出境,569,324,5,898
27/1/2020,二,沙頭角,入境,2212,189,36,2437
27/1/2020,二,沙頭角,出境,617,337,81,1035
27/1/2020,二,深圳灣,入境,27513,4507,759,32779
27/1/2020,二,深圳灣,出境,5065,6538,598,12201
27/1/2020,二,中國客運碼頭,入境,3124,477,431,4032
27/1/2020,二,中國客運碼頭,出境,944,530,411,1885
27/1/2020,二,港口管制,入境,69,0,32,101
27/1/2020,二,港口管制,出境,28,0,25,53
27/1/2020,二,啟德郵輪碼頭,入境,638,56,12,706
27/1/2020,二,啟德郵輪碼頭,出境,706,66,2190,2962
27/1/2020,二,港澳客輪碼頭,入境,7258,394,1271,8923
27/1/2020,二,港澳客輪碼頭,出境,4981,343,1094,6418
27/1/2020,二,屯門客運碼頭,入境,601,10,18,629
27/1/2020,二,屯門客運碼頭,出境,511,2,24,537
28/1/2020,二,機場,入境,54491,7187,5422,67100
28/1/2020,二,機場,出境,41100,8306,12151,61557
28/1/2020,二,高鐵西九龍,入境,13133,1828,322,15283
28/1/2020,二,高鐵西九龍,出境,864,2499,212,3575
28/1/2020,二,紅磡,入境,1754,194,64,2012
28/1/2020,二,紅磡,出境,203,316,56,575
28/1/2020,二,羅湖,入境,39880,3633,381,43894
28/1/2020,二,羅湖,出境,12598,4654,290,17542
28/1/2020,二,落馬洲支線,入境,17313,2575,194,20082
28/1/2020,二,落馬洲支線,出境,7253,3018,175,10446
28/1/2020,二,港珠澳大橋,入境,12420,1551,1534,15505
28/1/2020,二,港珠澳大橋,出境,5417,1795,1625,8837
28/1/2020,二,落馬洲,入境,10279,1831,329,12439
28/1/2020,二,落馬洲,出境,4780,2722,202,7704
28/1/2020,二,文錦渡,入境,1551,283,4,1838
28/1/2020,二,文錦渡,出境,582,269,3,854
28/1/2020,二,沙頭角,入境,2173,245,66,2484
28/1/2020,二,沙頭角,出境,433,210,58,701
28/1/2020,二,深圳灣,入境,26094,4217,738,31049
28/1/2020,二,深圳灣,出境,3797,5022,513,9332
28/1/2020,二,中國客運碼頭,入境,2761,314,222,3297
28/1/2020,二,中國客運碼頭,出境,509,371,323,1203
28/1/2020,二,港口管制,入境,17,0,34,51
28/1/2020,二,港口管制,出境,1,0,12,13
28/1/2020,二,啟德郵輪碼頭,入境,705,56,8,769
28/1/2020,二,啟德郵輪碼頭,出境,427,75,6,508
28/1/2020,二,港澳客輪碼頭,入境,5745,238,912,6895
28/1/2020,二,港澳客輪碼頭,出境,3634,288,864,4786
28/1/2020,二,屯門客運碼頭,入境,472,4,18,494
28/1/2020,二,屯門客運碼頭,出境,306,1,27,334
29/1/2020,二,機場,入境,50292,9196,5871,65359
29/1/2020,二,機場,出境,33880,7550,10514,51944
29/1/2020,二,高鐵西九龍,入境,20022,1817,403,22242
29/1/2020,二,高鐵西九龍,出境,1195,3524,261,4980
29/1/2020,二,紅磡,入境,2038,201,87,2326
29/1/2020,二,紅磡,出境,222,462,79,763
29/1/2020,二,羅湖,入境,44426,4343,485,49254
29/1/2020,二,羅湖,出境,13519,5099,350,18968
29/1/2020,二,落馬洲支線,入境,19574,3003,323,22900
29/1/2020,二,落馬洲支線,出境,8304,3414,245,11963
29/1/2020,二,港珠澳大橋,入境,10793,1363,1168,13324
29/1/2020,二,港珠澳大橋,出境,4213,1588,1479,7280
29/1/2020,二,落馬洲,入境,11236,1900,385,13521
29/1/2020,二,落馬洲,出境,5371,3111,252,8734
29/1/2020,二,文錦渡,入境,1459,293,11,1763
29/1/2020,二,文錦渡,出境,629,308,10,947
29/1/2020,二,沙頭角,入境,2739,320,61,3120
29/1/2020,二,沙頭角,出境,517,311,87,915
29/1/2020,二,深圳灣,入境,26892,4695,996,32583
29/1/2020,二,深圳灣,出境,4398,6648,678,11724
29/1/2020,二,中國客運碼頭,入境,3138,320,271,3729
29/1/2020,二,中國客運碼頭,出境,522,497,266,1285
29/1/2020,二,港口管制,入境,0,0,41,41
29/1/2020,二,港口管制,出境,0,0,0,0
29/1/2020,二,啟德郵輪碼頭,入境,427,75,10,512
29/1/2020,二,啟德郵輪碼頭,出境,372,49,21,442
29/1/2020,二,港澳客輪碼頭,入境,4223,250,869,5342
29/1/2020,二,港澳客輪碼頭,出境,3211,223,877,4311
29/1/2020,二,屯門客運碼頭,入境,313,4,17,334
29/1/2020,二,屯門客運碼頭,出境,293,1,24,318
30/1/2020,二,機場,入境,46214,9907,5530,61651
30/1/2020,二,機場,出境,31072,7122,9882,48076
30/1/2020,二,高鐵西九龍,入境,0,0,0,0
30/1/2020,二,高鐵西九龍,出境,0,0,0,0
30/1/2020,二,紅磡,入境,0,0,0,0
30/1/2020,二,紅磡,出境,0,0,0,0
30/1/2020,二,羅湖,入境,30427,2470,308,33205
30/1/2020,二,羅湖,出境,13178,3893,294,17365
30/1/2020,二,落馬洲支線,入境,15978,1711,205,17894
30/1/2020,二,落馬洲支線,出境,8048,2570,168,10786
30/1/2020,二,港珠澳大橋,入境,7032,946,923,8901
30/1/2020,二,港珠澳大橋,出境,3554,1360,1155,6069
30/1/2020,二,落馬洲,入境,9186,1430,312,10928
30/1/2020,二,落馬洲,出境,4706,3386,322,8414
30/1/2020,二,文錦渡,入境,0,0,0,0
30/1/2020,二,文錦渡,出境,0,0,0,0
30/1/2020,二,沙頭角,入境,0,0,0,0
30/1/2020,二,沙頭角,出境,0,0,0,0
30/1/2020,二,深圳灣,入境,17109,2785,660,20554
30/1/2020,二,深圳灣,出境,3707,6196,660,10563
30/1/2020,二,中國客運碼頭,入境,0,0,0,0
30/1/2020,二,中國客運碼頭,出境,0,0,0,0
30/1/2020,二,港口管制,入境,1,0,69,70
30/1/2020,二,港口管制,出境,0,0,22,22
30/1/2020,二,啟德郵輪碼頭,入境,2921,134,161,3216
30/1/2020,二,啟德郵輪碼頭,出境,682,52,1761,2495
30/1/2020,二,港澳客輪碼頭,入境,3638,172,694,4504
30/1/2020,二,港澳客輪碼頭,出境,3132,249,806,4187
30/1/2020,二,屯門客運碼頭,入境,0,0,0,0
30/1/2020,二,屯門客運碼頭,出境,0,0,0,0
31/1/2020,二,機場,入境,49093,7817,5089,61999
31/1/2020,二,機場,出境,28231,5737,7599,41567
31/1/2020,二,高鐵西九龍,入境,0,0,0,0
31/1/2020,二,高鐵西九龍,出境,0,0,0,0
31/1/2020,二,紅磡,入境,0,0,0,0
31/1/2020,二,紅磡,出境,0,0,0,0
31/1/2020,二,羅湖,入境,24064,1960,257,26281
31/1/2020,二,羅湖,出境,13695,2845,267,16807
31/1/2020,二,落馬洲支線,入境,14044,1518,181,15743
31/1/2020,二,落馬洲支線,出境,8490,1939,163,10592
31/1/2020,二,港珠澳大橋,入境,5754,653,883,7290
31/1/2020,二,港珠澳大橋,出境,3626,897,1078,5601
31/1/2020,二,落馬洲,入境,7807,1200,225,9232
31/1/2020,二,落馬洲,出境,4879,2598,302,7779
31/1/2020,二,文錦渡,入境,0,0,0,0
31/1/2020,二,文錦渡,出境,0,0,0,0
31/1/2020,二,沙頭角,入境,0,0,0,0
31/1/2020,二,沙頭角,出境,0,0,0,0
31/1/2020,二,深圳灣,入境,11541,2412,567,14520
31/1/2020,二,深圳灣,出境,3727,4789,632,9148
31/1/2020,二,中國客運碼頭,入境,0,0,0,0
31/1/2020,二,中國客運碼頭,出境,0,0,0,0
31/1/2020,二,港口管制,入境,2,0,330,332
31/1/2020,二,港口管制,出境,2,0,9,11
31/1/2020,二,啟德郵輪碼頭,入境,828,377,91,1296
31/1/2020,二,啟德郵輪碼頭,出境,1603,65,242,1910
31/1/2020,二,港澳客輪碼頭,入境,3411,121,634,4166
31/1/2020,二,港澳客輪碼頭,出境,3253,124,660,4037
31/1/2020,二,屯門客運碼頭,入境,0,0,0,0
31/1/2020,二,屯門客運碼頭,出境,0,0,0,0
1/2/2020,二,機場,入境,55976,5703,4567,66246
1/2/2020,二,機場,出境,28798,5072,8046,41916
1/2/2020,二,高鐵西九龍,入境,0,0,0,0
1/2/2020,二,高鐵西九龍,出境,0,0,0,0
1/2/2020,二,紅磡,入境,0,0,0,0
1/2/2020,二,紅磡,出境,0,0,0,0
1/2/2020,二,羅湖,入境,21578,1883,276,23737
1/2/2020,二,羅湖,出境,13759,2347,234,16340
1/2/2020,二,落馬洲支線,入境,12975,1505,165,14645
1/2/2020,二,落馬洲支線,出境,8541,1805,139,10485
1/2/2020,二,港珠澳大橋,入境,4926,632,1021,6579
1/2/2020,二,港珠澳大橋,出境,3259,784,1339,5382
1/2/2020,二,落馬洲,入境,6674,1134,236,8044
1/2/2020,二,落馬洲,出境,4940,1855,179,6974
1/2/2020,二,文錦渡,入境,0,0,0,0
1/2/2020,二,文錦渡,出境,0,0,0,0
1/2/2020,二,沙頭角,入境,0,0,0,0
1/2/2020,二,沙頭角,出境,0,0,0,0
1/2/2020,二,深圳灣,入境,9788,2429,505,12722
1/2/2020,二,深圳灣,出境,3378,3425,499,7302
1/2/2020,二,中國客運碼頭,入境,0,0,0,0
1/2/2020,二,中國客運碼頭,出境,0,0,0,0
1/2/2020,二,港口管制,入境,0,0,60,60
1/2/2020,二,港口管制,出境,0,0,5,5
1/2/2020,二,啟德郵輪碼頭,入境,25,8,2334,2367
1/2/2020,二,啟德郵輪碼頭,出境,129,6,1965,2100
1/2/2020,二,港澳客輪碼頭,入境,3180,88,596,3864
1/2/2020,二,港澳客輪碼頭,出境,3043,105,550,3698
1/2/2020,二,屯門客運碼頭,入境,0,0,0,0
1/2/2020,二,屯門客運碼頭,出境,0,0,0,0
2/2/2020,二,機場,入境,59083,4649,3762,67494
2/2/2020,二,機場,出境,25570,4360,6898,36828
2/2/2020,二,高鐵西九龍,入境,0,0,0,0
2/2/2020,二,高鐵西九龍,出境,0,0,0,0
2/2/2020,二,紅磡,入境,0,0,0,0
2/2/2020,二,紅磡,出境,0,0,0,0
2/2/2020,二,羅湖,入境,13138,1159,190,14487
2/2/2020,二,羅湖,出境,6575,1392,151,8118
2/2/2020,二,落馬洲支線,入境,17716,1739,177,19632
2/2/2020,二,落馬洲支線,出境,9832,2902,209,12943
2/2/2020,二,港珠澳大橋,入境,5108,487,804,6399
2/2/2020,二,港珠澳大橋,出境,3165,649,1270,5084
2/2/2020,二,落馬洲,入境,10954,1272,254,12480
2/2/2020,二,落馬洲,出境,4362,1820,234,6416
2/2/2020,二,文錦渡,入境,0,0,0,0
2/2/2020,二,文錦渡,出境,0,0,0,0
2/2/2020,二,沙頭角,入境,0,0,0,0
2/2/2020,二,沙頭角,出境,0,0,0,0
2/2/2020,二,深圳灣,入境,11706,2253,606,14565
2/2/2020,二,深圳灣,出境,2968,3130,454,6552
2/2/2020,二,中國客運碼頭,入境,0,0,0,0
2/2/2020,二,中國客運碼頭,出境,0,0,0,0
2/2/2020,二,港口管制,入境,0,0,184,184
2/2/2020,二,港口管制,出境,0,0,0,0
2/2/2020,二,啟德郵輪碼頭,入境,1637,58,53,1748
2/2/2020,二,啟德郵輪碼頭,出境,2172,22,241,2435
2/2/2020,二,港澳客輪碼頭,入境,3057,98,369,3524
2/2/2020,二,港澳客輪碼頭,出境,2697,110,486,3293
2/2/2020,二,屯門客運碼頭,入境,0,0,0,0
2/2/2020,二,屯門客運碼頭,出境,0,0,0,0
3/2/2020,二,機場,入境,41208,6996,3846,52050
3/2/2020,二,機場,出境,21704,3596,5428,30728
3/2/2020,二,高鐵西九龍,入境,0,0,0,0
3/2/2020,二,高鐵西九龍,出境,0,0,0,0
3/2/2020,二,紅磡,入境,0,0,0,0
3/2/2020,二,紅磡,出境,0,0,0,0
3/2/2020,二,羅湖,入境,27196,1873,368,29437
3/2/2020,二,羅湖,出境,14938,3078,320,18336
3/2/2020,二,落馬洲支線,入境,17037,1038,242,18317
3/2/2020,二,落馬洲支線,出境,10113,1815,205,12133
3/2/2020,二,港珠澳大橋,入境,3595,358,674,4627
3/2/2020,二,港珠澳大橋,出境,3023,723,849,4595
3/2/2020,二,落馬洲,入境,9823,1206,281,11310
3/2/2020,二,落馬洲,出境,5461,2150,190,7801
3/2/2020,二,文錦渡,入境,0,0,0,0
3/2/2020,二,文錦渡,出境,0,0,0,0
3/2/2020,二,沙頭角,入境,0,0,0,0
3/2/2020,二,沙頭角,出境,0,0,0,0
3/2/2020,二,深圳灣,入境,8284,1871,504,10659
3/2/2020,二,深圳灣,出境,3960,3754,486,8200
3/2/2020,二,中國客運碼頭,入境,0,0,0,0
3/2/2020,二,中國客運碼頭,出境,0,0,0,0
3/2/2020,二,港口管制,入境,0,0,25,25
3/2/2020,二,港口管制,出境,0,0,29,29
3/2/2020,二,啟德郵輪碼頭,入境,330,22,6,358
3/2/2020,二,啟德郵輪碼頭,出境,203,21,4,228
3/2/2020,二,港澳客輪碼頭,入境,3560,97,564,4221
3/2/2020,二,港澳客輪碼頭,出境,3333,109,589,4031
3/2/2020,二,屯門客運碼頭,入境,0,0,0,0
3/2/2020,二,屯門客運碼頭,出境,0,0,0,0
4/2/2020,二,機場,入境,31173,6317,3647,41137
4/2/2020,二,機場,出境,20187,3550,4471,28208
4/2/2020,二,高鐵西九龍,入境,0,0,0,0
4/2/2020,二,高鐵西九龍,出境,0,0,0,0
4/2/2020,二,紅磡,入境,0,0,0,0
4/2/2020,二,紅磡,出境,0,0,0,0
4/2/2020,二,羅湖,入境,0,0,0,0
4/2/2020,二,羅湖,出境,0,0,0,0
4/2/2020,二,落馬洲支線,入境,0,0,0,0
4/2/2020,二,落馬洲支線,出境,0,0,0,0
4/2/2020,二,港珠澳大橋,入境,4555,402,1020,5977
4/2/2020,二,港珠澳大橋,出境,3177,985,1020,5182
4/2/2020,二,落馬洲,入境,0,0,0,0
4/2/2020,二,落馬洲,出境,0,0,0,0
4/2/2020,二,文錦渡,入境,0,0,0,0
4/2/2020,二,文錦渡,出境,0,0,0,0
4/2/2020,二,沙頭角,入境,0,0,0,0
4/2/2020,二,沙頭角,出境,0,0,0,0
4/2/2020,二,深圳灣,入境,18852,2771,786,22409
4/2/2020,二,深圳灣,出境,10838,6731,809,18378
4/2/2020,二,中國客運碼頭,入境,0,0,0,0
4/2/2020,二,中國客運碼頭,出境,0,0,0,0
4/2/2020,二,港口管制,入境,33,0,30,63
4/2/2020,二,港口管制,出境,30,0,33,63
4/2/2020,二,啟德郵輪碼頭,入境,203,21,2,226
4/2/2020,二,啟德郵輪碼頭,出境,173,10,2,185
4/2/2020,二,港澳客輪碼頭,入境,0,0,0,0
4/2/2020,二,港澳客輪碼頭,出境,0,0,0,0
4/2/2020,二,屯門客運碼頭,入境,0,0,0,0
4/2/2020,二,屯門客運碼頭,出境,0,0,0,0
5/2/2020,二,機場,入境,24832,6041,3592,34465
5/2/2020,二,機場,出境,22297,2591,4404,29292
5/2/2020,二,高鐵西九龍,入境,0,0,0,0
5/2/2020,二,高鐵西九龍,出境,0,0,0,0
5/2/2020,二,紅磡,入境,0,0,0,0
5/2/2020,二,紅磡,出境,0,0,0,0
5/2/2020,二,羅湖,入境,0,0,0,0
5/2/2020,二,羅湖,出境,0,0,0,0
5/2/2020,二,落馬洲支線,入境,0,0,0,0
5/2/2020,二,落馬洲支線,出境,0,0,0,0
5/2/2020,二,港珠澳大橋,入境,3172,329,1121,4622
5/2/2020,二,港珠澳大橋,出境,2025,925,885,3835
5/2/2020,二,落馬洲,入境,0,0,0,0
5/2/2020,二,落馬洲,出境,0,0,0,0
5/2/2020,二,文錦渡,入境,0,0,0,0
5/2/2020,二,文錦渡,出境,0,0,0,0
5/2/2020,二,沙頭角,入境,0,0,0,0
5/2/2020,二,沙頭角,出境,0,0,0,0
5/2/2020,二,深圳灣,入境,16387,2378,714,19479
5/2/2020,二,深圳灣,出境,11893,6359,837,19089
5/2/2020,二,中國客運碼頭,入境,0,0,0,0
5/2/2020,二,中國客運碼頭,出境,0,0,0,0
5/2/2020,二,港口管制,入境,0,0,0,0
5/2/2020,二,港口管制,出境,0,0,0,0
5/2/2020,二,啟德郵輪碼頭,入境,175,12,31,218
5/2/2020,二,啟德郵輪碼頭,出境,2,2,0,4
5/2/2020,二,港澳客輪碼頭,入境,0,0,0,0
5/2/2020,二,港澳客輪碼頭,出境,0,0,0,0
5/2/2020,二,屯門客運碼頭,入境,0,0,0,0
5/2/2020,二,屯門客運碼頭,出境,0,0,0,0
6/2/2020,二,機場,入境,21261,5728,3478,30467
6/2/2020,二,機場,出境,22252,2512,4222,28986
6/2/2020,二,高鐵西九龍,入境,0,0,0,0
6/2/2020,二,高鐵西九龍,出境,0,0,0,0
6/2/2020,二,紅磡,入境,0,0,0,0
6/2/2020,二,紅磡,出境,0,0,0,0
6/2/2020,二,羅湖,入境,0,0,0,0
6/2/2020,二,羅湖,出境,0,0,0,0
6/2/2020,二,落馬洲支線,入境,0,0,0,0
6/2/2020,二,落馬洲支線,出境,0,0,0,0
6/2/2020,二,港珠澳大橋,入境,4941,468,1188,6597
6/2/2020,二,港珠澳大橋,出境,2608,1068,834,4510
6/2/2020,二,落馬洲,入境,0,0,0,0
6/2/2020,二,落馬洲,出境,0,0,0,0
6/2/2020,二,文錦渡,入境,0,0,0,0
6/2/2020,二,文錦渡,出境,0,0,0,0
6/2/2020,二,沙頭角,入境,0,0,0,0
6/2/2020,二,沙頭角,出境,0,0,0,0
6/2/2020,二,深圳灣,入境,38920,4813,1220,44953
6/2/2020,二,深圳灣,出境,21360,7071,1197,29628
6/2/2020,二,中國客運碼頭,入境,0,0,0,0
6/2/2020,二,中國客運碼頭,出境,0,0,0,0
6/2/2020,二,港口管制,入境,0,0,0,0
6/2/2020,二,港口管制,出境,0,0,0,0
6/2/2020,二,啟德郵輪碼頭,入境,0,0,0,0
6/2/2020,二,啟德郵輪碼頭,出境,0,0,0,0
6/2/2020,二,港澳客輪碼頭,入境,0,0,0,0
6/2/2020,二,港澳客輪碼頭,出境,0,0,0,0
6/2/2020,二,屯門客運碼頭,入境,0,0,0,0
6/2/2020,二,屯門客運碼頭,出境,0,0,0,0
7/2/2020,二,機場,入境,19694,5563,3556,28813
7/2/2020,二,機場,出境,21417,2735,4012,28164
7/2/2020,二,高鐵西九龍,入境,0,0,0,0
7/2/2020,二,高鐵西九龍,出境,0,0,0,0
7/2/2020,二,紅磡,入境,0,0,0,0
7/2/2020,二,紅磡,出境,0,0,0,0
7/2/2020,二,羅湖,入境,0,0,0,0
7/2/2020,二,羅湖,出境,0,0,0,0
7/2/2020,二,落馬洲支線,入境,0,0,0,0
7/2/2020,二,落馬洲支線,出境,0,0,0,0
7/2/2020,二,港珠澳大橋,入境,6699,628,1340,8667
7/2/2020,二,港珠澳大橋,出境,2576,1102,798,4476
7/2/2020,二,落馬洲,入境,0,0,0,0
7/2/2020,二,落馬洲,出境,0,0,0,0
7/2/2020,二,文錦渡,入境,0,0,0,0
7/2/2020,二,文錦渡,出境,0,0,0,0
7/2/2020,二,沙頭角,入境,0,0,0,0
7/2/2020,二,沙頭角,出境,0,0,0,0
7/2/2020,二,深圳灣,入境,50506,6555,1441,58502
7/2/2020,二,深圳灣,出境,16746,7282,1320,25348
7/2/2020,二,中國客運碼頭,入境,0,0,0,0
7/2/2020,二,中國客運碼頭,出境,0,0,0,0
7/2/2020,二,港口管制,入境,0,0,0,0
7/2/2020,二,港口管制,出境,0,0,0,0
7/2/2020,二,啟德郵輪碼頭,入境,0,0,0,0
7/2/2020,二,啟德郵輪碼頭,出境,0,0,0,0
7/2/2020,二,港澳客輪碼頭,入境,0,0,0,0
7/2/2020,二,港澳客輪碼頭,出境,0,0,0,0
7/2/2020,二,屯門客運碼頭,入境,0,0,0,0
7/2/2020,二,屯門客運碼頭,出境,0,0,0,0
8/2/2020,二,機場,入境,17956,943,3070,21969
8/2/2020,二,機場,出境,20163,1127,3253,24543
8/2/2020,二,高鐵西九龍,入境,0,0,0,0
8/2/2020,二,高鐵西九龍,出境,0,0,0,0
8/2/2020,二,紅磡,入境,0,0,0,0
8/2/2020,二,紅磡,出境,0,0,0,0
8/2/2020,二,羅湖,入境,0,0,0,0
8/2/2020,二,羅湖,出境,0,0,0,0
8/2/2020,二,落馬洲支線,入境,0,0,0,0
8/2/2020,二,落馬洲支線,出境,0,0,0,0
8/2/2020,二,港珠澳大橋,入境,659,9,508,1176
8/2/2020,二,港珠澳大橋,出境,750,163,442,1355
8/2/2020,二,落馬洲,入境,0,0,0,0
8/2/2020,二,落馬洲,出境,0,0,0,0
8/2/2020,二,文錦渡,入境,0,0,0,0
8/2/2020,二,文錦渡,出境,0,0,0,0
8/2/2020,二,沙頭角,入境,0,0,0,0
8/2/2020,二,沙頭角,出境,0,0,0,0
8/2/2020,二,深圳灣,入境,208,43,3,254
8/2/2020,二,深圳灣,出境,1291,1351,549,3191
8/2/2020,二,中國客運碼頭,入境,0,0,0,0
8/2/2020,二,中國客運碼頭,出境,0,0,0,0
8/2/2020,二,港口管制,入境,0,0,0,0
8/2/2020,二,港口管制,出境,0,0,0,0
8/2/2020,二,啟德郵輪碼頭,入境,0,0,0,0
8/2/2020,二,啟德郵輪碼頭,出境,0,0,0,0
8/2/2020,二,港澳客輪碼頭,入境,0,0,0,0
8/2/2020,二,港澳客輪碼頭,出境,0,0,0,0
8/2/2020,二,屯門客運碼頭,入境,0,0,0,0
8/2/2020,二,屯門客運碼頭,出境,0,0,0,0
9/2/2020,二,機場,入境,22077,913,2591,25581
9/2/2020,二,機場,出境,17782,971,3200,21953
9/2/2020,二,高鐵西九龍,入境,0,0,0,0
9/2/2020,二,高鐵西九龍,出境,0,0,0,0
9/2/2020,二,紅磡,入境,0,0,0,0
9/2/2020,二,紅磡,出境,0,0,0,0
9/2/2020,二,羅湖,入境,0,0,0,0
9/2/2020,二,羅湖,出境,0,0,0,0
9/2/2020,二,落馬洲支線,入境,0,0,0,0
9/2/2020,二,落馬洲支線,出境,0,0,0,0
9/2/2020,二,港珠澳大橋,入境,710,7,493,1210
9/2/2020,二,港珠澳大橋,出境,1185,167,524,1876
9/2/2020,二,落馬洲,入境,0,0,0,0
9/2/2020,二,落馬洲,出境,0,0,0,0
9/2/2020,二,文錦渡,入境,0,0,0,0
9/2/2020,二,文錦渡,出境,0,0,0,0
9/2/2020,二,沙頭角,入境,0,0,0,0
9/2/2020,二,沙頭角,出境,0,0,0,0
9/2/2020,二,深圳灣,入境,314,36,3,353
9/2/2020,二,深圳灣,出境,1802,1303,573,3678
9/2/2020,二,中國客運碼頭,入境,0,0,0,0
9/2/2020,二,中國客運碼頭,出境,0,0,0,0
9/2/2020,二,港口管制,入境,0,0,0,0
9/2/2020,二,港口管制,出境,0,0,0,0
9/2/2020,二,啟德郵輪碼頭,入境,1838,0,33,1871
9/2/2020,二,啟德郵輪碼頭,出境,0,0,0,0
9/2/2020,二,港澳客輪碼頭,入境,0,0,0,0
9/2/2020,二,港澳客輪碼頭,出境,0,0,0,0
9/2/2020,二,屯門客運碼頭,入境,0,0,0,0
9/2/2020,二,屯門客運碼頭,出境,0,0,0,0
10/2/2020,二,機場,入境,17139,766,2037,19942
10/2/2020,二,機場,出境,15550,535,3219,19304
10/2/2020,二,高鐵西九龍,入境,0,0,0,0
10/2/2020,二,高鐵西九龍,出境,0,0,0,0
10/2/2020,二,紅磡,入境,0,0,0,0
10/2/2020,二,紅磡,出境,0,0,0,0
10/2/2020,二,羅湖,入境,0,0,0,0
10/2/2020,二,羅湖,出境,0,0,0,0
10/2/2020,二,落馬洲支線,入境,0,0,0,0
10/2/2020,二,落馬洲支線,出境,0,0,0,0
10/2/2020,二,港珠澳大橋,入境,808,10,496,1314
10/2/2020,二,港珠澳大橋,出境,1508,137,444,2089
10/2/2020,二,落馬洲,入境,0,0,0,0
10/2/2020,二,落馬洲,出境,0,0,0,0
10/2/2020,二,文錦渡,入境,0,0,0,0
10/2/2020,二,文錦渡,出境,0,0,0,0
10/2/2020,二,沙頭角,入境,0,0,0,0
10/2/2020,二,沙頭角,出境,0,0,0,0
10/2/2020,二,深圳灣,入境,461,56,4,521
10/2/2020,二,深圳灣,出境,1835,1016,185,3036
10/2/2020,二,中國客運碼頭,入境,0,0,0,0
10/2/2020,二,中國客運碼頭,出境,0,0,0,0
10/2/2020,二,港口管制,入境,0,0,0,0
10/2/2020,二,港口管制,出境,0,0,0,0
10/2/2020,二,啟德郵輪碼頭,入境,0,0,0,0
10/2/2020,二,啟德郵輪碼頭,出境,0,0,0,0
10/2/2020,二,港澳客輪碼頭,入境,0,0,0,0
10/2/2020,二,港澳客輪碼頭,出境,0,0,0,0
10/2/2020,二,屯門客運碼頭,入境,0,0,0,0
10/2/2020,二,屯門客運碼頭,出境,0,0,0,0
11/2/2020,二,機場,入境,14663,647,2107,17417
11/2/2020,二,機場,出境,12645,481,2556,15682
11/2/2020,二,高鐵西九龍,入境,0,0,0,0
11/2/2020,二,高鐵西九龍,出境,0,0,0,0
11/2/2020,二,紅磡,入境,0,0,0,0
11/2/2020,二,紅磡,出境,0,0,0,0
11/2/2020,二,羅湖,入境,0,0,0,0
11/2/2020,二,羅湖,出境,0,0,0,0
11/2/2020,二,落馬洲支線,入境,0,0,0,0
11/2/2020,二,落馬洲支線,出境,0,0,0,0
11/2/2020,二,港珠澳大橋,入境,729,11,458,1198
11/2/2020,二,港珠澳大橋,出境,960,103,452,1515
11/2/2020,二,落馬洲,入境,0,0,0,0
11/2/2020,二,落馬洲,出境,0,0,0,0
11/2/2020,二,文錦渡,入境,0,0,0,0
11/2/2020,二,文錦渡,出境,0,0,0,0
11/2/2020,二,沙頭角,入境,0,0,0,0
11/2/2020,二,沙頭角,出境,0,0,0,0
11/2/2020,二,深圳灣,入境,561,80,4,645
11/2/2020,二,深圳灣,出境,1105,739,140,1984
11/2/2020,二,中國客運碼頭,入境,0,0,0,0
11/2/2020,二,中國客運碼頭,出境,0,0,0,0
11/2/2020,二,港口管制,入境,0,0,0,0
11/2/2020,二,港口管制,出境,0,0,0,0
11/2/2020,二,啟德郵輪碼頭,入境,0,0,0,0
11/2/2020,二,啟德郵輪碼頭,出境,0,0,0,0
11/2/2020,二,港澳客輪碼頭,入境,0,0,0,0
11/2/2020,二,港澳客輪碼頭,出境,0,0,0,0
11/2/2020,二,屯門客運碼頭,入境,0,0,0,0
11/2/2020,二,屯門客運碼頭,出境,0,0,0,0
12/2/2020,二,機場,入境,14221,619,1725,16565
12/2/2020,二,機場,出境,13637,471,2358,16466
12/2/2020,二,高鐵西九龍,入境,0,0,0,0
12/2/2020,二,高鐵西九龍,出境,0,0,0,0
12/2/2020,二,紅磡,入境,0,0,0,0
12/2/2020,二,紅磡,出境,0,0,0,0
12/2/2020,二,羅湖,入境,0,0,0,0
12/2/2020,二,羅湖,出境,0,0,0,0
12/2/2020,二,落馬洲支線,入境,0,0,0,0
12/2/2020,二,落馬洲支線,出境,0,0,0,0
12/2/2020,二,港珠澳大橋,入境,862,4,449,1315
12/2/2020,二,港珠澳大橋,出境,904,109,350,1363
12/2/2020,二,落馬洲,入境,0,0,0,0
12/2/2020,二,落馬洲,出境,0,0,0,0
12/2/2020,二,文錦渡,入境,0,0,0,0
12/2/2020,二,文錦渡,出境,0,0,0,0
12/2/2020,二,沙頭角,入境,0,0,0,0
12/2/2020,二,沙頭角,出境,0,0,0,0
12/2/2020,二,深圳灣,入境,709,106,2,817
12/2/2020,二,深圳灣,出境,1219,862,114,2195
12/2/2020,二,中國客運碼頭,入境,0,0,0,0
12/2/2020,二,中國客運碼頭,出境,0,0,0,0
12/2/2020,二,港口管制,入境,0,0,0,0
12/2/2020,二,港口管制,出境,0,0,0,0
12/2/2020,二,啟德郵輪碼頭,入境,0,0,0,0
12/2/2020,二,啟德郵輪碼頭,出境,0,0,0,0
12/2/2020,二,港澳客輪碼頭,入境,0,0,0,0
12/2/2020,二,港澳客輪碼頭,出境,0,0,0,0
12/2/2020,二,屯門客運碼頭,入境,0,0,0,0
12/2/2020,二,屯門客運碼頭,出境,0,0,0,0
13/2/2020,二,機場,入境,11620,638,1938,14196
13/2/2020,二,機場,出境,15259,453,2150,17862
13/2/2020,二,高鐵西九龍,入境,0,0,0,0
13/2/2020,二,高鐵西九龍,出境,0,0,0,0
13/2/2020,二,紅磡,入境,0,0,0,0
13/2/2020,二,紅磡,出境,0,0,0,0
13/2/2020,二,羅湖,入境,0,0,0,0
13/2/2020,二,羅湖,出境,0,0,0,0
13/2/2020,二,落馬洲支線,入境,0,0,0,0
13/2/2020,二,落馬洲支線,出境,0,0,0,0
13/2/2020,二,港珠澳大橋,入境,936,8,503,1447
13/2/2020,二,港珠澳大橋,出境,1089,124,450,1663
13/2/2020,二,落馬洲,入境,0,0,0,0
13/2/2020,二,落馬洲,出境,0,0,0,0
13/2/2020,二,文錦渡,入境,0,0,0,0
13/2/2020,二,文錦渡,出境,0,0,0,0
13/2/2020,二,沙頭角,入境,0,0,0,0
13/2/2020,二,沙頭角,出境,0,0,0,0
13/2/2020,二,深圳灣,入境,756,105,17,878
13/2/2020,二,深圳灣,出境,1056,856,104,2016
13/2/2020,二,中國客運碼頭,入境,0,0,0,0
13/2/2020,二,中國客運碼頭,出境,0,0,0,0
13/2/2020,二,港口管制,入境,0,0,0,0
13/2/2020,二,港口管制,出境,0,0,0,0
13/2/2020,二,啟德郵輪碼頭,入境,0,0,0,0
13/2/2020,二,啟德郵輪碼頭,出境,0,0,0,0
13/2/2020,二,港澳客輪碼頭,入境,0,0,0,0
13/2/2020,二,港澳客輪碼頭,出境,0,0,0,0
13/2/2020,二,屯門客運碼頭,入境,0,0,0,0
13/2/2020,二,屯門客運碼頭,出境,0,0,0,0
14/2/2020,二,機場,入境,11246,584,2015,13845
14/2/2020,二,機場,出境,15770,477,2012,18259
14/2/2020,二,高鐵西九龍,入境,0,0,0,0
14/2/2020,二,高鐵西九龍,出境,0,0,0,0
14/2/2020,二,紅磡,入境,0,0,0,0
14/2/2020,二,紅磡,出境,0,0,0,0
14/2/2020,二,羅湖,入境,0,0,0,0
14/2/2020,二,羅湖,出境,0,0,0,0
14/2/2020,二,落馬洲支線,入境,0,0,0,0
14/2/2020,二,落馬洲支線,出境,0,0,0,0
14/2/2020,二,港珠澳大橋,入境,1491,5,553,2049
14/2/2020,二,港珠澳大橋,出境,1298,110,447,1855
14/2/2020,二,落馬洲,入境,0,0,0,0
14/2/2020,二,落馬洲,出境,0,0,0,0
14/2/2020,二,文錦渡,入境,0,0,0,0
14/2/2020,二,文錦渡,出境,0,0,0,0
14/2/2020,二,沙頭角,入境,0,0,0,0
14/2/2020,二,沙頭角,出境,0,0,0,0
14/2/2020,二,深圳灣,入境,770,94,6,870
14/2/2020,二,深圳灣,出境,1092,1016,117,2225
14/2/2020,二,中國客運碼頭,入境,0,0,0,0
14/2/2020,二,中國客運碼頭,出境,0,0,0,0
14/2/2020,二,港口管制,入境,0,0,0,0
14/2/2020,二,港口管制,出境,0,0,0,0
14/2/2020,二,啟德郵輪碼頭,入境,0,0,0,0
14/2/2020,二,啟德郵輪碼頭,出境,0,0,0,0
14/2/2020,二,港澳客輪碼頭,入境,0,0,0,0
14/2/2020,二,港澳客輪碼頭,出境,0,0,0,0
14/2/2020,二,屯門客運碼頭,入境,0,0,0,0
14/2/2020,二,屯門客運碼頭,出境,0,0,0,0
15/2/2020,二,機場,入境,14097,692,2098,16887
15/2/2020,二,機場,出境,14575,390,2064,17029
15/2/2020,二,高鐵西九龍,入境,0,0,0,0
15/2/2020,二,高鐵西九龍,出境,0,0,0,0
15/2/2020,二,紅磡,入境,0,0,0,0
15/2/2020,二,紅磡,出境,0,0,0,0
15/2/2020,二,羅湖,入境,0,0,0,0
15/2/2020,二,羅湖,出境,0,0,0,0
15/2/2020,二,落馬洲支線,入境,0,0,0,0
15/2/2020,二,落馬洲支線,出境,0,0,0,0
15/2/2020,二,港珠澳大橋,入境,1183,5,524,1712
15/2/2020,二,港珠澳大橋,出境,1060,119,486,1665
15/2/2020,二,落馬洲,入境,0,0,0,0
15/2/2020,二,落馬洲,出境,0,0,0,0
15/2/2020,二,文錦渡,入境,0,0,0,0
15/2/2020,二,文錦渡,出境,0,0,0,0
15/2/2020,二,沙頭角,入境,0,0,0,0
15/2/2020,二,沙頭角,出境,0,0,0,0
15/2/2020,二,深圳灣,入境,809,94,7,910
15/2/2020,二,深圳灣,出境,945,621,150,1716
15/2/2020,二,中國客運碼頭,入境,0,0,0,0
15/2/2020,二,中國客運碼頭,出境,0,0,0,0
15/2/2020,二,港口管制,入境,0,0,0,0
15/2/2020,二,港口管制,出境,0,0,0,0
15/2/2020,二,啟德郵輪碼頭,入境,0,0,0,0
15/2/2020,二,啟德郵輪碼頭,出境,0,0,0,0
15/2/2020,二,港澳客輪碼頭,入境,0,0,0,0
15/2/2020,二,港澳客輪碼頭,出境,0,0,0,0
15/2/2020,二,屯門客運碼頭,入境,0,0,0,0
15/2/2020,二,屯門客運碼頭,出境,0,0,0,0
16/2/2020,二,機場,入境,18422,650,1848,20920
16/2/2020,二,機場,出境,12257,349,2524,15130
16/2/2020,二,高鐵西九龍,入境,0,0,0,0
16/2/2020,二,高鐵西九龍,出境,0,0,0,0
16/2/2020,二,紅磡,入境,0,0,0,0
16/2/2020,二,紅磡,出境,0,0,0,0
16/2/2020,二,羅湖,入境,0,0,0,0
16/2/2020,二,羅湖,出境,0,0,0,0
16/2/2020,二,落馬洲支線,入境,0,0,0,0
16/2/2020,二,落馬洲支線,出境,0,0,0,0
16/2/2020,二,港珠澳大橋,入境,1106,2,465,1573
16/2/2020,二,港珠澳大橋,出境,1473,76,646,2195
16/2/2020,二,落馬洲,入境,0,0,0,0
16/2/2020,二,落馬洲,出境,0,0,0,0
16/2/2020,二,文錦渡,入境,0,0,0,0
16/2/2020,二,文錦渡,出境,0,0,0,0
16/2/2020,二,沙頭角,入境,0,0,0,0
16/2/2020,二,沙頭角,出境,0,0,0,0
16/2/2020,二,深圳灣,入境,797,97,6,900
16/2/2020,二,深圳灣,出境,1166,764,203,2133
16/2/2020,二,中國客運碼頭,入境,0,0,0,0
16/2/2020,二,中國客運碼頭,出境,0,0,0,0
16/2/2020,二,港口管制,入境,0,0,0,0
16/2/2020,二,港口管制,出境,0,0,0,0
16/2/2020,二,啟德郵輪碼頭,入境,0,0,0,0
16/2/2020,二,啟德郵輪碼頭,出境,0,0,0,0
16/2/2020,二,港澳客輪碼頭,入境,0,0,0,0
16/2/2020,二,港澳客輪碼頭,出境,0,0,0,0
16/2/2020,二,屯門客運碼頭,入境,0,0,0,0
16/2/2020,二,屯門客運碼頭,出境,0,0,0,0
17/2/2020,二,機場,入境,13748,532,1876,16156
17/2/2020,二,機場,出境,10210,212,2018,12440
17/2/2020,二,高鐵西九龍,入境,0,0,0,0
17/2/2020,二,高鐵西九龍,出境,0,0,0,0
17/2/2020,二,紅磡,入境,0,0,0,0
17/2/2020,二,紅磡,出境,0,0,0,0
17/2/2020,二,羅湖,入境,0,0,0,0
17/2/2020,二,羅湖,出境,0,0,0,0
17/2/2020,二,落馬洲支線,入境,0,0,0,0
17/2/2020,二,落馬洲支線,出境,0,0,0,0
17/2/2020,二,港珠澳大橋,入境,1264,3,488,1755
17/2/2020,二,港珠澳大橋,出境,2000,87,625,2712
17/2/2020,二,落馬洲,入境,0,0,0,0
17/2/2020,二,落馬洲,出境,0,0,0,0
17/2/2020,二,文錦渡,入境,0,0,0,0
17/2/2020,二,文錦渡,出境,0,0,0,0
17/2/2020,二,沙頭角,入境,0,0,0,0
17/2/2020,二,沙頭角,出境,0,0,0,0
17/2/2020,二,深圳灣,入境,978,108,4,1090
17/2/2020,二,深圳灣,出境,1724,600,173,2497
17/2/2020,二,中國客運碼頭,入境,0,0,0,0
17/2/2020,二,中國客運碼頭,出境,0,0,0,0
17/2/2020,二,港口管制,入境,0,0,0,0
17/2/2020,二,港口管制,出境,0,0,0,0
17/2/2020,二,啟德郵輪碼頭,入境,0,0,0,0
17/2/2020,二,啟德郵輪碼頭,出境,0,0,0,0
17/2/2020,二,港澳客輪碼頭,入境,0,0,0,0
17/2/2020,二,港澳客輪碼頭,出境,0,0,0,0
17/2/2020,二,屯門客運碼頭,入境,0,0,0,0
17/2/2020,二,屯門客運碼頭,出境,0,0,0,0
18/2/2020,二,機場,入境,12068,479,1862,14409
18/2/2020,二,機場,出境,8900,266,1722,10888
18/2/2020,二,高鐵西九龍,入境,0,0,0,0
18/2/2020,二,高鐵西九龍,出境,0,0,0,0
18/2/2020,二,紅磡,入境,0,0,0,0
18/2/2020,二,紅磡,出境,0,0,0,0
18/2/2020,二,羅湖,入境,0,0,0,0
18/2/2020,二,羅湖,出境,0,0,0,0
18/2/2020,二,落馬洲支線,入境,0,0,0,0
18/2/2020,二,落馬洲支線,出境,0,0,0,0
18/2/2020,二,港珠澳大橋,入境,1361,5,579,1945
18/2/2020,二,港珠澳大橋,出境,1955,74,730,2759
18/2/2020,二,落馬洲,入境,0,0,0,0
18/2/2020,二,落馬洲,出境,0,0,0,0
18/2/2020,二,文錦渡,入境,0,0,0,0
18/2/2020,二,文錦渡,出境,0,0,0,0
18/2/2020,二,沙頭角,入境,0,0,0,0
18/2/2020,二,沙頭角,出境,0,0,0,0
18/2/2020,二,深圳灣,入境,954,95,10,1059
18/2/2020,二,深圳灣,出境,1160,519,155,1834
18/2/2020,二,中國客運碼頭,入境,0,0,0,0
18/2/2020,二,中國客運碼頭,出境,0,0,0,0
18/2/2020,二,港口管制,入境,0,0,0,0
18/2/2020,二,港口管制,出境,0,0,0,0
18/2/2020,二,啟德郵輪碼頭,入境,0,0,0,0
18/2/2020,二,啟德郵輪碼頭,出境,0,0,0,0
18/2/2020,二,港澳客輪碼頭,入境,0,0,0,0
18/2/2020,二,港澳客輪碼頭,出境,0,0,0,0
18/2/2020,二,屯門客運碼頭,入境,0,0,0,0
18/2/2020,二,屯門客運碼頭,出境,0,0,0,0
19/2/2020,二,機場,入境,10612,462,1789,12863
19/2/2020,二,機場,出境,10048,214,1582,11844
19/2/2020,二,高鐵西九龍,入境,0,0,0,0
19/2/2020,二,高鐵西九龍,出境,0,0,0,0
19/2/2020,二,紅磡,入境,0,0,0,0
19/2/2020,二,紅磡,出境,0,0,0,0
19/2/2020,二,羅湖,入境,0,0,0,0
19/2/2020,二,羅湖,出境,0,0,0,0
19/2/2020,二,落馬洲支線,入境,0,0,0,0
19/2/2020,二,落馬洲支線,出境,0,0,0,0
19/2/2020,二,港珠澳大橋,入境,1280,8,496,1784
19/2/2020,二,港珠澳大橋,出境,1776,64,609,2449
19/2/2020,二,落馬洲,入境,0,0,0,0
19/2/2020,二,落馬洲,出境,0,0,0,0
19/2/2020,二,文錦渡,入境,0,0,0,0
19/2/2020,二,文錦渡,出境,0,0,0,0
19/2/2020,二,沙頭角,入境,0,0,0,0
19/2/2020,二,沙頭角,出境,0,0,0,0
19/2/2020,二,深圳灣,入境,909,97,5,1011
19/2/2020,二,深圳灣,出境,1145,508,113,1766
19/2/2020,二,中國客運碼頭,入境,0,0,0,0
19/2/2020,二,中國客運碼頭,出境,0,0,0,0
19/2/2020,二,港口管制,入境,0,0,0,0
19/2/2020,二,港口管制,出境,0,0,0,0
19/2/2020,二,啟德郵輪碼頭,入境,0,0,0,0
19/2/2020,二,啟德郵輪碼頭,出境,0,0,0,0
19/2/2020,二,港澳客輪碼頭,入境,0,0,0,0
19/2/2020,二,港澳客輪碼頭,出境,0,0,0,0
19/2/2020,二,屯門客運碼頭,入境,0,0,0,0
19/2/2020,二,屯門客運碼頭,出境,0,0,0,0
20/2/2020,二,機場,入境,10398,525,1730,12653
20/2/2020,二,機場,出境,11622,280,1944,13846
20/2/2020,二,高鐵西九龍,入境,0,0,0,0
20/2/2020,二,高鐵西九龍,出境,0,0,0,0
20/2/2020,二,紅磡,入境,0,0,0,0
20/2/2020,二,紅磡,出境,0,0,0,0
20/2/2020,二,羅湖,入境,0,0,0,0
20/2/2020,二,羅湖,出境,0,0,0,0
20/2/2020,二,落馬洲支線,入境,0,0,0,0
20/2/2020,二,落馬洲支線,出境,0,0,0,0
20/2/2020,二,港珠澳大橋,入境,2299,13,585,2897
20/2/2020,二,港珠澳大橋,出境,3135,96,551,3782
20/2/2020,二,落馬洲,入境,0,0,0,0
20/2/2020,二,落馬洲,出境,0,0,0,0
20/2/2020,二,文錦渡,入境,0,0,0,0
20/2/2020,二,文錦渡,出境,0,0,0,0
20/2/2020,二,沙頭角,入境,0,0,0,0
20/2/2020,二,沙頭角,出境,0,0,0,0
20/2/2020,二,深圳灣,入境,980,110,9,1099
20/2/2020,二,深圳灣,出境,1167,564,111,1842
20/2/2020,二,中國客運碼頭,入境,0,0,0,0
20/2/2020,二,中國客運碼頭,出境,0,0,0,0
20/2/2020,二,港口管制,入境,0,0,0,0
20/2/2020,二,港口管制,出境,0,0,0,0
20/2/2020,二,啟德郵輪碼頭,入境,0,0,0,0
20/2/2020,二,啟德郵輪碼頭,出境,0,0,0,0
20/2/2020,二,港澳客輪碼頭,入境,0,0,0,0
20/2/2020,二,港澳客輪碼頭,出境,0,0,0,0
20/2/2020,二,屯門客運碼頭,入境,0,0,0,0
20/2/2020,二,屯門客運碼頭,出境,0,0,0,0
21/2/2020,二,機場,入境,9821,539,2007,12367
21/2/2020,二,機場,出境,12942,356,1749,15047
21/2/2020,二,高鐵西九龍,入境,0,0,0,0
21/2/2020,二,高鐵西九龍,出境,0,0,0,0
21/2/2020,二,紅磡,入境,0,0,0,0
21/2/2020,二,紅磡,出境,0,0,0,0
21/2/2020,二,羅湖,入境,0,0,0,0
21/2/2020,二,羅湖,出境,0,0,0,0
21/2/2020,二,落馬洲支線,入境,0,0,0,0
21/2/2020,二,落馬洲支線,出境,0,0,0,0
21/2/2020,二,港珠澳大橋,入境,3647,28,685,4360
21/2/2020,二,港珠澳大橋,出境,3362,95,549,4006
21/2/2020,二,落馬洲,入境,0,0,0,0
21/2/2020,二,落馬洲,出境,0,0,0,0
21/2/2020,二,文錦渡,入境,0,0,0,0
21/2/2020,二,文錦渡,出境,0,0,0,0
21/2/2020,二,沙頭角,入境,0,0,0,0
21/2/2020,二,沙頭角,出境,0,0,0,0
21/2/2020,二,深圳灣,入境,1089,115,4,1208
21/2/2020,二,深圳灣,出境,1195,534,115,1844
21/2/2020,二,中國客運碼頭,入境,0,0,0,0
21/2/2020,二,中國客運碼頭,出境,0,0,0,0
21/2/2020,二,港口管制,入境,0,0,0,0
21/2/2020,二,港口管制,出境,0,0,0,0
21/2/2020,二,啟德郵輪碼頭,入境,0,0,0,0
21/2/2020,二,啟德郵輪碼頭,出境,0,0,0,0
21/2/2020,二,港澳客輪碼頭,入境,0,0,0,0
21/2/2020,二,港澳客輪碼頭,出境,0,0,0,0
21/2/2020,二,屯門客運碼頭,入境,0,0,0,0
21/2/2020,二,屯門客運碼頭,出境,0,0,0,0
22/2/2020,二,機場,入境,11096,530,2030,13656
22/2/2020,二,機場,出境,10534,247,1888,12669
22/2/2020,二,高鐵西九龍,入境,0,0,0,0
22/2/2020,二,高鐵西九龍,出境,0,0,0,0
22/2/2020,二,紅磡,入境,0,0,0,0
22/2/2020,二,紅磡,出境,0,0,0,0
22/2/2020,二,羅湖,入境,0,0,0,0
22/2/2020,二,羅湖,出境,0,0,0,0
22/2/2020,二,落馬洲支線,入境,0,0,0,0
22/2/2020,二,落馬洲支線,出境,0,0,0,0
22/2/2020,二,港珠澳大橋,入境,3364,14,648,4026
22/2/2020,二,港珠澳大橋,出境,3511,83,641,4235
22/2/2020,二,落馬洲,入境,0,0,0,0
22/2/2020,二,落馬洲,出境,0,0,0,0
22/2/2020,二,文錦渡,入境,0,0,0,0
22/2/2020,二,文錦渡,出境,0,0,0,0
22/2/2020,二,沙頭角,入境,0,0,0,0
22/2/2020,二,沙頭角,出境,0,0,0,0
22/2/2020,二,深圳灣,入境,980,107,2,1089
22/2/2020,二,深圳灣,出境,1115,487,124,1726
22/2/2020,二,中國客運碼頭,入境,0,0,0,0
22/2/2020,二,中國客運碼頭,出境,0,0,0,0
22/2/2020,二,港口管制,入境,0,0,0,0
22/2/2020,二,港口管制,出境,0,0,0,0
22/2/2020,二,啟德郵輪碼頭,入境,0,0,0,0
22/2/2020,二,啟德郵輪碼頭,出境,0,0,0,0
22/2/2020,二,港澳客輪碼頭,入境,0,0,0,0
22/2/2020,二,港澳客輪碼頭,出境,0,0,0,0
22/2/2020,二,屯門客運碼頭,入境,0,0,0,0
22/2/2020,二,屯門客運碼頭,出境,0,0,0,0
23/2/2020,二,機場,入境,15891,537,2009,18437
23/2/2020,二,機場,出境,9225,296,2141,11662
23/2/2020,二,高鐵西九龍,入境,0,0,0,0
23/2/2020,二,高鐵西九龍,出境,0,0,0,0
23/2/2020,二,紅磡,入境,0,0,0,0
23/2/2020,二,紅磡,出境,0,0,0,0
23/2/2020,二,羅湖,入境,0,0,0,0
23/2/2020,二,羅湖,出境,0,0,0,0
23/2/2020,二,落馬洲支線,入境,0,0,0,0
23/2/2020,二,落馬洲支線,出境,0,0,0,0
23/2/2020,二,港珠澳大橋,入境,3203,10,633,3846
23/2/2020,二,港珠澳大橋,出境,3342,86,775,4203
23/2/2020,二,落馬洲,入境,0,0,0,0
23/2/2020,二,落馬洲,出境,0,0,0,0
23/2/2020,二,文錦渡,入境,0,0,0,0
23/2/2020,二,文錦渡,出境,0,0,0,0
23/2/2020,二,沙頭角,入境,0,0,0,0
23/2/2020,二,沙頭角,出境,0,0,0,0
23/2/2020,二,深圳灣,入境,1147,126,9,1282
23/2/2020,二,深圳灣,出境,1338,579,273,2190
23/2/2020,二,中國客運碼頭,入境,0,0,0,0
23/2/2020,二,中國客運碼頭,出境,0,0,0,0
23/2/2020,二,港口管制,入境,0,0,0,0
23/2/2020,二,港口管制,出境,0,0,0,0
23/2/2020,二,啟德郵輪碼頭,入境,0,0,0,0
23/2/2020,二,啟德郵輪碼頭,出境,0,0,0,0
23/2/2020,二,港澳客輪碼頭,入境,0,0,0,0
23/2/2020,二,港澳客輪碼頭,出境,0,0,0,0
23/2/2020,二,屯門客運碼頭,入境,0,0,0,0
23/2/2020,二,屯門客運碼頭,出境,0,0,0,0
24/2/2020,二,機場,入境,12267,451,1792,14510
24/2/2020,二,機場,出境,8041,231,1919,10191
24/2/2020,二,高鐵西九龍,入境,0,0,0,0
24/2/2020,二,高鐵西九龍,出境,0,0,0,0
24/2/2020,二,紅磡,入境,0,0,0,0
24/2/2020,二,紅磡,出境,0,0,0,0
24/2/2020,二,羅湖,入境,0,0,0,0
24/2/2020,二,羅湖,出境,0,0,0,0
24/2/2020,二,落馬洲支線,入境,0,0,0,0
24/2/2020,二,落馬洲支線,出境,0,0,0,0
24/2/2020,二,港珠澳大橋,入境,3352,7,611,3970
24/2/2020,二,港珠澳大橋,出境,4211,74,682,4967
24/2/2020,二,落馬洲,入境,0,0,0,0
24/2/2020,二,落馬洲,出境,0,0,0,0
24/2/2020,二,文錦渡,入境,0,0,0,0
24/2/2020,二,文錦渡,出境,0,0,0,0
24/2/2020,二,沙頭角,入境,0,0,0,0
24/2/2020,二,沙頭角,出境,0,0,0,0
24/2/2020,二,深圳灣,入境,1353,130,7,1490
24/2/2020,二,深圳灣,出境,1964,482,181,2627
24/2/2020,二,中國客運碼頭,入境,0,0,0,0
24/2/2020,二,中國客運碼頭,出境,0,0,0,0
24/2/2020,二,港口管制,入境,0,0,0,0
24/2/2020,二,港口管制,出境,0,0,0,0
24/2/2020,二,啟德郵輪碼頭,入境,0,0,0,0
24/2/2020,二,啟德郵輪碼頭,出境,0,0,0,0
24/2/2020,二,港澳客輪碼頭,入境,0,0,0,0
24/2/2020,二,港澳客輪碼頭,出境,0,0,0,0
24/2/2020,二,屯門客運碼頭,入境,0,0,0,0
24/2/2020,二,屯門客運碼頭,出境,0,0,0,0
25/2/2020,二,機場,入境,10734,414,1471,12619
25/2/2020,二,機場,出境,7458,181,1574,9213
25/2/2020,二,高鐵西九龍,入境,0,0,0,0
25/2/2020,二,高鐵西九龍,出境,0,0,0,0
25/2/2020,二,紅磡,入境,0,0,0,0
25/2/2020,二,紅磡,出境,0,0,0,0
25/2/2020,二,羅湖,入境,0,0,0,0
25/2/2020,二,羅湖,出境,0,0,0,0
25/2/2020,二,落馬洲支線,入境,0,0,0,0
25/2/2020,二,落馬洲支線,出境,0,0,0,0
25/2/2020,二,港珠澳大橋,入境,3145,13,591,3749
25/2/2020,二,港珠澳大橋,出境,3281,88,593,3962
25/2/2020,二,落馬洲,入境,0,0,0,0
25/2/2020,二,落馬洲,出境,0,0,0,0
25/2/2020,二,文錦渡,入境,0,0,0,0
25/2/2020,二,文錦渡,出境,0,0,0,0
25/2/2020,二,沙頭角,入境,0,0,0,0
25/2/2020,二,沙頭角,出境,0,0,0,0
25/2/2020,二,深圳灣,入境,1328,131,5,1464
25/2/2020,二,深圳灣,出境,1510,503,141,2154
25/2/2020,二,中國客運碼頭,入境,0,0,0,0
25/2/2020,二,中國客運碼頭,出境,0,0,0,0
25/2/2020,二,港口管制,入境,0,0,0,0
25/2/2020,二,港口管制,出境,0,0,0,0
25/2/2020,二,啟德郵輪碼頭,入境,0,0,0,0
25/2/2020,二,啟德郵輪碼頭,出境,0,0,0,0
25/2/2020,二,港澳客輪碼頭,入境,0,0,0,0
25/2/2020,二,港澳客輪碼頭,出境,0,0,0,0
25/2/2020,二,屯門客運碼頭,入境,0,0,0,0
25/2/2020,二,屯門客運碼頭,出境,0,0,0,0
26/2/2020,二,機場,入境,9882,410,1484,11776
26/2/2020,二,機場,出境,7629,212,1521,9362
26/2/2020,二,高鐵西九龍,入境,0,0,0,0
26/2/2020,二,高鐵西九龍,出境,0,0,0,0
26/2/2020,二,紅磡,入境,0,0,0,0
26/2/2020,二,紅磡,出境,0,0,0,0
26/2/2020,二,羅湖,入境,0,0,0,0
26/2/2020,二,羅湖,出境,0,0,0,0
26/2/2020,二,落馬洲支線,入境,0,0,0,0
26/2/2020,二,落馬洲支線,出境,0,0,0,0
26/2/2020,二,港珠澳大橋,入境,3233,11,662,3906
26/2/2020,二,港珠澳大橋,出境,3424,78,580,4082
26/2/2020,二,落馬洲,入境,0,0,0,0
26/2/2020,二,落馬洲,出境,0,0,0,0
26/2/2020,二,文錦渡,入境,0,0,0,0
26/2/2020,二,文錦渡,出境,0,0,0,0
26/2/2020,二,沙頭角,入境,0,0,0,0
26/2/2020,二,沙頭角,出境,0,0,0,0
26/2/2020,二,深圳灣,入境,1202,166,11,1379
26/2/2020,二,深圳灣,出境,1695,548,179,2422
26/2/2020,二,中國客運碼頭,入境,0,0,0,0
26/2/2020,二,中國客運碼頭,出境,0,0,0,0
26/2/2020,二,港口管制,入境,0,0,0,0
26/2/2020,二,港口管制,出境,0,0,0,0
26/2/2020,二,啟德郵輪碼頭,入境,0,0,0,0
26/2/2020,二,啟德郵輪碼頭,出境,0,0,0,0
26/2/2020,二,港澳客輪碼頭,入境,0,0,0,0
26/2/2020,二,港澳客輪碼頭,出境,0,0,0,0
26/2/2020,二,屯門客運碼頭,入境,0,0,0,0
26/2/2020,二,屯門客運碼頭,出境,0,0,0,0
27/2/2020,二,機場,入境,9177,512,1780,11469
27/2/2020,二,機場,出境,9051,168,1501,10720
27/2/2020,二,高鐵西九龍,入境,0,0,0,0
27/2/2020,二,高鐵西九龍,出境,0,0,0,0
27/2/2020,二,紅磡,入境,0,0,0,0
27/2/2020,二,紅磡,出境,0,0,0,0
27/2/2020,二,羅湖,入境,0,0,0,0
27/2/2020,二,羅湖,出境,0,0,0,0
27/2/2020,二,落馬洲支線,入境,0,0,0,0
27/2/2020,二,落馬洲支線,出境,0,0,0,0
27/2/2020,二,港珠澳大橋,入境,3420,20,616,4056
27/2/2020,二,港珠澳大橋,出境,3672,99,670,4441
27/2/2020,二,落馬洲,入境,0,0,0,0
27/2/2020,二,落馬洲,出境,0,0,0,0
27/2/2020,二,文錦渡,入境,0,0,0,0
27/2/2020,二,文錦渡,出境,0,0,0,0
27/2/2020,二,沙頭角,入境,0,0,0,0
27/2/2020,二,沙頭角,出境,0,0,0,0
27/2/2020,二,深圳灣,入境,1249,170,8,1427
27/2/2020,二,深圳灣,出境,1564,647,183,2394
27/2/2020,二,中國客運碼頭,入境,0,0,0,0
27/2/2020,二,中國客運碼頭,出境,0,0,0,0
27/2/2020,二,港口管制,入境,0,0,0,0
27/2/2020,二,港口管制,出境,0,0,0,0
27/2/2020,二,啟德郵輪碼頭,入境,0,0,0,0
27/2/2020,二,啟德郵輪碼頭,出境,0,0,0,0
27/2/2020,二,港澳客輪碼頭,入境,0,0,0,0
27/2/2020,二,港澳客輪碼頭,出境,0,0,0,0
27/2/2020,二,屯門客運碼頭,入境,0,0,0,0
27/2/2020,二,屯門客運碼頭,出境,0,0,0,0
28/2/2020,二,機場,入境,9205,369,1767,11341
28/2/2020,二,機場,出境,10755,255,1747,12757
28/2/2020,二,高鐵西九龍,入境,0,0,0,0
28/2/2020,二,高鐵西九龍,出境,0,0,0,0
28/2/2020,二,紅磡,入境,0,0,0,0
28/2/2020,二,紅磡,出境,0,0,0,0
28/2/2020,二,羅湖,入境,0,0,0,0
28/2/2020,二,羅湖,出境,0,0,0,0
28/2/2020,二,落馬洲支線,入境,0,0,0,0
28/2/2020,二,落馬洲支線,出境,0,0,0,0
28/2/2020,二,港珠澳大橋,入境,4763,8,865,5636
28/2/2020,二,港珠澳大橋,出境,4669,90,663,5422
28/2/2020,二,落馬洲,入境,0,0,0,0
28/2/2020,二,落馬洲,出境,0,0,0,0
28/2/2020,二,文錦渡,入境,0,0,0,0
28/2/2020,二,文錦渡,出境,0,0,0,0
28/2/2020,二,沙頭角,入境,0,0,0,0
28/2/2020,二,沙頭角,出境,0,0,0,0
28/2/2020,二,深圳灣,入境,1280,181,10,1471
28/2/2020,二,深圳灣,出境,1724,566,175,2465
28/2/2020,二,中國客運碼頭,入境,0,0,0,0
28/2/2020,二,中國客運碼頭,出境,0,0,0,0
28/2/2020,二,港口管制,入境,0,0,0,0
28/2/2020,二,港口管制,出境,0,0,0,0
28/2/2020,二,啟德郵輪碼頭,入境,0,0,0,0
28/2/2020,二,啟德郵輪碼頭,出境,0,0,0,0
28/2/2020,二,港澳客輪碼頭,入境,0,0,0,0
28/2/2020,二,港澳客輪碼頭,出境,0,0,0,0
28/2/2020,二,屯門客運碼頭,入境,0,0,0,0
28/2/2020,二,屯門客運碼頭,出境,0,0,0,0
29/2/2020,二,機場,入境,11818,870,1893,14581
29/2/2020,二,機場,出境,9860,230,1688,11778
29/2/2020,二,高鐵西九龍,入境,0,0,0,0
29/2/2020,二,高鐵西九龍,出境,0,0,0,0
29/2/2020,二,紅磡,入境,0,0,0,0
29/2/2020,二,紅磡,出境,0,0,0,0
29/2/2020,二,羅湖,入境,0,0,0,0
29/2/2020,二,羅湖,出境,0,0,0,0
29/2/2020,二,落馬洲支線,入境,0,0,0,0
29/2/2020,二,落馬洲支線,出境,0,0,0,0
29/2/2020,二,港珠澳大橋,入境,4676,19,901,5596
29/2/2020,二,港珠澳大橋,出境,4866,87,787,5740
29/2/2020,二,落馬洲,入境,0,0,0,0
29/2/2020,二,落馬洲,出境,0,0,0,0
29/2/2020,二,文錦渡,入境,0,0,0,0
29/2/2020,二,文錦渡,出境,0,0,0,0
29/2/2020,二,沙頭角,入境,0,0,0,0
29/2/2020,二,沙頭角,出境,0,0,0,0
29/2/2020,二,深圳灣,入境,1387,195,3,1585
29/2/2020,二,深圳灣,出境,1807,947,329,3083
29/2/2020,二,中國客運碼頭,入境,0,0,0,0
29/2/2020,二,中國客運碼頭,出境,0,0,0,0
29/2/2020,二,港口管制,入境,0,0,0,0
29/2/2020,二,港口管制,出境,0,0,0,0
29/2/2020,二,啟德郵輪碼頭,入境,0,0,0,0
29/2/2020,二,啟德郵輪碼頭,出境,0,0,0,0
29/2/2020,二,港澳客輪碼頭,入境,0,0,0,0
29/2/2020,二,港澳客輪碼頭,出境,0,0,0,0
29/2/2020,二,屯門客運碼頭,入境,0,0,0,0
29/2/2020,二,屯門客運碼頭,出境,0,0,0,0
1/3/2020,二,機場,入境,14584,1122,2461,18167
1/3/2020,二,機場,出境,9115,354,1850,11319
1/3/2020,二,高鐵西九龍,入境,0,0,0,0
1/3/2020,二,高鐵西九龍,出境,0,0,0,0
1/3/2020,二,紅磡,入境,0,0,0,0
1/3/2020,二,紅磡,出境,0,0,0,0
1/3/2020,二,羅湖,入境,0,0,0,0
1/3/2020,二,羅湖,出境,0,0,0,0
1/3/2020,二,落馬洲支線,入境,0,0,0,0
1/3/2020,二,落馬洲支線,出境,0,0,0,0
1/3/2020,二,港珠澳大橋,入境,4820,13,767,5600
1/3/2020,二,港珠澳大橋,出境,4587,194,905,5686
1/3/2020,二,落馬洲,入境,0,0,0,0
1/3/2020,二,落馬洲,出境,0,0,0,0
1/3/2020,二,文錦渡,入境,0,0,0,0
1/3/2020,二,文錦渡,出境,0,0,0,0
1/3/2020,二,沙頭角,入境,0,0,0,0
1/3/2020,二,沙頭角,出境,0,0,0,0
1/3/2020,二,深圳灣,入境,1587,211,9,1807
1/3/2020,二,深圳灣,出境,2053,1247,931,4231
1/3/2020,二,中國客運碼頭,入境,0,0,0,0
1/3/2020,二,中國客運碼頭,出境,0,0,0,0
1/3/2020,二,港口管制,入境,0,0,0,0
1/3/2020,二,港口管制,出境,0,0,0,0
1/3/2020,二,啟德郵輪碼頭,入境,0,0,0,0
1/3/2020,二,啟德郵輪碼頭,出境,0,0,0,0
1/3/2020,二,港澳客輪碼頭,入境,0,0,0,0
1/3/2020,二,港澳客輪碼頭,出境,0,0,0,0
1/3/2020,二,屯門客運碼頭,入境,0,0,0,0
1/3/2020,二,屯門客運碼頭,出境,0,0,0,0
2/3/2020,二,機場,入境,10261,732,1935,12928
2/3/2020,二,機場,出境,6755,206,1314,8275
2/3/2020,二,高鐵西九龍,入境,0,0,0,0
2/3/2020,二,高鐵西九龍,出境,0,0,0,0
2/3/2020,二,紅磡,入境,0,0,0,0
2/3/2020,二,紅磡,出境,0,0,0,0
2/3/2020,二,羅湖,入境,0,0,0,0
2/3/2020,二,羅湖,出境,0,0,0,0
2/3/2020,二,落馬洲支線,入境,0,0,0,0
2/3/2020,二,落馬洲支線,出境,0,0,0,0
2/3/2020,二,港珠澳大橋,入境,4244,10,738,4992
2/3/2020,二,港珠澳大橋,出境,5321,93,836,6250
2/3/2020,二,落馬洲,入境,0,0,0,0
2/3/2020,二,落馬洲,出境,0,0,0,0
2/3/2020,二,文錦渡,入境,0,0,0,0
2/3/2020,二,文錦渡,出境,0,0,0,0
2/3/2020,二,沙頭角,入境,0,0,0,0
2/3/2020,二,沙頭角,出境,0,0,0,0
2/3/2020,二,深圳灣,入境,2124,231,9,2364
2/3/2020,二,深圳灣,出境,2551,924,655,4130
2/3/2020,二,中國客運碼頭,入境,0,0,0,0
2/3/2020,二,中國客運碼頭,出境,0,0,0,0
2/3/2020,二,港口管制,入境,0,0,0,0
2/3/2020,二,港口管制,出境,0,0,0,0
2/3/2020,二,啟德郵輪碼頭,入境,0,0,0,0
2/3/2020,二,啟德郵輪碼頭,出境,0,0,0,0
2/3/2020,二,港澳客輪碼頭,入境,0,0,0,0
2/3/2020,二,港澳客輪碼頭,出境,0,0,0,0
2/3/2020,二,屯門客運碼頭,入境,0,0,0,0
2/3/2020,二,屯門客運碼頭,出境,0,0,0,0
3/3/2020,二,機場,入境,7960,734,1923,10617
3/3/2020,二,機場,出境,6684,190,1349,8223
3/3/2020,二,高鐵西九龍,入境,0,0,0,0
3/3/2020,二,高鐵西九龍,出境,0,0,0,0
3/3/2020,二,紅磡,入境,0,0,0,0
3/3/2020,二,紅磡,出境,0,0,0,0
3/3/2020,二,羅湖,入境,0,0,0,0
3/3/2020,二,羅湖,出境,0,0,0,0
3/3/2020,二,落馬洲支線,入境,0,0,0,0
3/3/2020,二,落馬洲支線,出境,0,0,0,0
3/3/2020,二,港珠澳大橋,入境,4398,19,756,5173
3/3/2020,二,港珠澳大橋,出境,4798,117,780,5695
3/3/2020,二,落馬洲,入境,0,0,0,0
3/3/2020,二,落馬洲,出境,0,0,0,0
3/3/2020,二,文錦渡,入境,0,0,0,0
3/3/2020,二,文錦渡,出境,0,0,0,0
3/3/2020,二,沙頭角,入境,0,0,0,0
3/3/2020,二,沙頭角,出境,0,0,0,0
3/3/2020,二,深圳灣,入境,1479,165,3,1647
3/3/2020,二,深圳灣,出境,1970,793,667,3430
3/3/2020,二,中國客運碼頭,入境,0,0,0,0
3/3/2020,二,中國客運碼頭,出境,0,0,0,0
3/3/2020,二,港口管制,入境,0,0,0,0
3/3/2020,二,港口管制,出境,0,0,0,0
3/3/2020,二,啟德郵輪碼頭,入境,0,0,0,0
3/3/2020,二,啟德郵輪碼頭,出境,0,0,0,0
3/3/2020,二,港澳客輪碼頭,入境,0,0,0,0
3/3/2020,二,港澳客輪碼頭,出境,0,0,0,0
3/3/2020,二,屯門客運碼頭,入境,0,0,0,0
3/3/2020,二,屯門客運碼頭,出境,0,0,0,0
4/3/2020,二,機場,入境,7590,772,1847,10209
4/3/2020,二,機場,出境,7170,213,1123,8506
4/3/2020,二,高鐵西九龍,入境,0,0,0,0
4/3/2020,二,高鐵西九龍,出境,0,0,0,0
4/3/2020,二,紅磡,入境,0,0,0,0
4/3/2020,二,紅磡,出境,0,0,0,0
4/3/2020,二,羅湖,入境,0,0,0,0
4/3/2020,二,羅湖,出境,0,0,0,0
4/3/2020,二,落馬洲支線,入境,0,0,0,0
4/3/2020,二,落馬洲支線,出境,0,0,0,0
4/3/2020,二,港珠澳大橋,入境,4368,9,753,5130
4/3/2020,二,港珠澳大橋,出境,4539,92,802,5433
4/3/2020,二,落馬洲,入境,0,0,0,0
4/3/2020,二,落馬洲,出境,0,0,0,0
4/3/2020,二,文錦渡,入境,0,0,0,0
4/3/2020,二,文錦渡,出境,0,0,0,0
4/3/2020,二,沙頭角,入境,0,0,0,0
4/3/2020,二,沙頭角,出境,0,0,0,0
4/3/2020,二,深圳灣,入境,1306,192,7,1505
4/3/2020,二,深圳灣,出境,1684,806,664,3154
4/3/2020,二,中國客運碼頭,入境,0,0,0,0
4/3/2020,二,中國客運碼頭,出境,0,0,0,0
4/3/2020,二,港口管制,入境,0,0,0,0
4/3/2020,二,港口管制,出境,0,0,0,0
4/3/2020,二,啟德郵輪碼頭,入境,0,0,0,0
4/3/2020,二,啟德郵輪碼頭,出境,0,0,0,0
4/3/2020,二,港澳客輪碼頭,入境,0,0,0,0
4/3/2020,二,港澳客輪碼頭,出境,0,0,0,0
4/3/2020,二,屯門客運碼頭,入境,0,0,0,0
4/3/2020,二,屯門客運碼頭,出境,0,0,0,0
5/3/2020,二,機場,入境,7074,673,1749,9496
5/3/2020,二,機場,出境,8141,190,1289,9620
5/3/2020,二,高鐵西九龍,入境,0,0,0,0
5/3/2020,二,高鐵西九龍,出境,0,0,0,0
5/3/2020,二,紅磡,入境,0,0,0,0
5/3/2020,二,紅磡,出境,0,0,0,0
5/3/2020,二,羅湖,入境,0,0,0,0
5/3/2020,二,羅湖,出境,0,0,0,0
5/3/2020,二,落馬洲支線,入境,0,0,0,0
5/3/2020,二,落馬洲支線,出境,0,0,0,0
5/3/2020,二,港珠澳大橋,入境,4752,17,782,5551
5/3/2020,二,港珠澳大橋,出境,4999,96,776,5871
5/3/2020,二,落馬洲,入境,0,0,0,0
5/3/2020,二,落馬洲,出境,0,0,0,0
5/3/2020,二,文錦渡,入境,0,0,0,0
5/3/2020,二,文錦渡,出境,0,0,0,0
5/3/2020,二,沙頭角,入境,0,0,0,0
5/3/2020,二,沙頭角,出境,0,0,0,0
5/3/2020,二,深圳灣,入境,1419,226,3,1648
5/3/2020,二,深圳灣,出境,1589,767,638,2994
5/3/2020,二,中國客運碼頭,入境,0,0,0,0
5/3/2020,二,中國客運碼頭,出境,0,0,0,0
5/3/2020,二,港口管制,入境,0,0,0,0
5/3/2020,二,港口管制,出境,0,0,0,0
5/3/2020,二,啟德郵輪碼頭,入境,0,0,0,0
5/3/2020,二,啟德郵輪碼頭,出境,0,0,0,0
5/3/2020,二,港澳客輪碼頭,入境,0,0,0,0
5/3/2020,二,港澳客輪碼頭,出境,0,0,0,0
5/3/2020,二,屯門客運碼頭,入境,0,0,0,0
5/3/2020,二,屯門客運碼頭,出境,0,0,0,0
6/3/2020,二,機場,入境,7474,705,1877,10056
6/3/2020,二,機場,出境,8746,215,1150,10111
6/3/2020,二,高鐵西九龍,入境,0,0,0,0
6/3/2020,二,高鐵西九龍,出境,0,0,0,0
6/3/2020,二,紅磡,入境,0,0,0,0
6/3/2020,二,紅磡,出境,0,0,0,0
6/3/2020,二,羅湖,入境,0,0,0,0
6/3/2020,二,羅湖,出境,0,0,0,0
6/3/2020,二,落馬洲支線,入境,0,0,0,0
6/3/2020,二,落馬洲支線,出境,0,0,0,0
6/3/2020,二,港珠澳大橋,入境,6255,22,894,7171
6/3/2020,二,港珠澳大橋,出境,6030,116,768,6914
6/3/2020,二,落馬洲,入境,0,0,0,0
6/3/2020,二,落馬洲,出境,0,0,0,0
6/3/2020,二,文錦渡,入境,0,0,0,0
6/3/2020,二,文錦渡,出境,0,0,0,0
6/3/2020,二,沙頭角,入境,0,0,0,0
6/3/2020,二,沙頭角,出境,0,0,0,0
6/3/2020,二,深圳灣,入境,1425,251,8,1684
6/3/2020,二,深圳灣,出境,1550,734,544,2828
6/3/2020,二,中國客運碼頭,入境,0,0,0,0
6/3/2020,二,中國客運碼頭,出境,0,0,0,0
6/3/2020,二,港口管制,入境,0,0,0,0
6/3/2020,二,港口管制,出境,0,0,0,0
6/3/2020,二,啟德郵輪碼頭,入境,0,0,0,0
6/3/2020,二,啟德郵輪碼頭,出境,0,0,0,0
6/3/2020,二,港澳客輪碼頭,入境,0,0,0,0
6/3/2020,二,港澳客輪碼頭,出境,0,0,0,0
6/3/2020,二,屯門客運碼頭,入境,0,0,0,0
6/3/2020,二,屯門客運碼頭,出境,0,0,0,0
7/3/2020,二,機場,入境,8659,795,1919,11373
7/3/2020,二,機場,出境,7316,216,1398,8930
7/3/2020,二,高鐵西九龍,入境,0,0,0,0
7/3/2020,二,高鐵西九龍,出境,0,0,0,0
7/3/2020,二,紅磡,入境,0,0,0,0
7/3/2020,二,紅磡,出境,0,0,0,0
7/3/2020,二,羅湖,入境,0,0,0,0
7/3/2020,二,羅湖,出境,0,0,0,0
7/3/2020,二,落馬洲支線,入境,0,0,0,0
7/3/2020,二,落馬洲支線,出境,0,0,0,0
7/3/2020,二,港珠澳大橋,入境,5935,26,973,6934
7/3/2020,二,港珠澳大橋,出境,6440,132,903,7475
7/3/2020,二,落馬洲,入境,0,0,0,0
7/3/2020,二,落馬洲,出境,0,0,0,0
7/3/2020,二,文錦渡,入境,0,0,0,0
7/3/2020,二,文錦渡,出境,0,0,0,0
7/3/2020,二,沙頭角,入境,0,0,0,0
7/3/2020,二,沙頭角,出境,0,0,0,0
7/3/2020,二,深圳灣,入境,1180,269,2,1451
7/3/2020,二,深圳灣,出境,1380,856,622,2858
7/3/2020,二,中國客運碼頭,入境,0,0,0,0
7/3/2020,二,中國客運碼頭,出境,0,0,0,0
7/3/2020,二,港口管制,入境,0,0,0,0
7/3/2020,二,港口管制,出境,0,0,0,0
7/3/2020,二,啟德郵輪碼頭,入境,0,0,0,0
7/3/2020,二,啟德郵輪碼頭,出境,0,0,0,0
7/3/2020,二,港澳客輪碼頭,入境,0,0,0,0
7/3/2020,二,港澳客輪碼頭,出境,0,0,0,0
7/3/2020,二,屯門客運碼頭,入境,0,0,0,0
7/3/2020,二,屯門客運碼頭,出境,0,0,0,0
8/3/2020,二,機場,入境,12538,730,1833,15101
8/3/2020,二,機場,出境,6371,276,1376,8023
8/3/2020,二,高鐵西九龍,入境,0,0,0,0
8/3/2020,二,高鐵西九龍,出境,0,0,0,0
8/3/2020,二,紅磡,入境,0,0,0,0
8/3/2020,二,紅磡,出境,0,0,0,0
8/3/2020,二,羅湖,入境,0,0,0,0
8/3/2020,二,羅湖,出境,0,0,0,0
8/3/2020,二,落馬洲支線,入境,0,0,0,0
8/3/2020,二,落馬洲支線,出境,0,0,0,0
8/3/2020,二,港珠澳大橋,入境,6331,23,806,7160
8/3/2020,二,港珠澳大橋,出境,5935,109,1127,7171
8/3/2020,二,落馬洲,入境,0,0,0,0
8/3/2020,二,落馬洲,出境,0,0,0,0
8/3/2020,二,文錦渡,入境,0,0,0,0
8/3/2020,二,文錦渡,出境,0,0,0,0
8/3/2020,二,沙頭角,入境,0,0,0,0
8/3/2020,二,沙頭角,出境,0,0,0,0
8/3/2020,二,深圳灣,入境,1386,252,9,1647
8/3/2020,二,深圳灣,出境,1547,897,678,3122
8/3/2020,二,中國客運碼頭,入境,0,0,0,0
8/3/2020,二,中國客運碼頭,出境,0,0,0,0
8/3/2020,二,港口管制,入境,0,0,0,0
8/3/2020,二,港口管制,出境,0,0,0,0
8/3/2020,二,啟德郵輪碼頭,入境,0,0,0,0
8/3/2020,二,啟德郵輪碼頭,出境,0,0,0,0
8/3/2020,二,港澳客輪碼頭,入境,0,0,0,0
8/3/2020,二,港澳客輪碼頭,出境,0,0,0,0
8/3/2020,二,屯門客運碼頭,入境,0,0,0,0
8/3/2020,二,屯門客運碼頭,出境,0,0,0,0
9/3/2020,二,機場,入境,8304,706,1623,10633
9/3/2020,二,機場,出境,4721,139,970,5830
9/3/2020,二,高鐵西九龍,入境,0,0,0,0
9/3/2020,二,高鐵西九龍,出境,0,0,0,0
9/3/2020,二,紅磡,入境,0,0,0,0
9/3/2020,二,紅磡,出境,0,0,0,0
9/3/2020,二,羅湖,入境,0,0,0,0
9/3/2020,二,羅湖,出境,0,0,0,0
9/3/2020,二,落馬洲支線,入境,0,0,0,0
9/3/2020,二,落馬洲支線,出境,0,0,0,0
9/3/2020,二,港珠澳大橋,入境,5638,16,805,6459
9/3/2020,二,港珠澳大橋,出境,6224,133,929,7286
9/3/2020,二,落馬洲,入境,0,0,0,0
9/3/2020,二,落馬洲,出境,0,0,0,0
9/3/2020,二,文錦渡,入境,0,0,0,0
9/3/2020,二,文錦渡,出境,0,0,0,0
9/3/2020,二,沙頭角,入境,0,0,0,0
9/3/2020,二,沙頭角,出境,0,0,0,0
9/3/2020,二,深圳灣,入境,1632,233,10,1875
9/3/2020,二,深圳灣,出境,2197,774,592,3563
9/3/2020,二,中國客運碼頭,入境,0,0,0,0
9/3/2020,二,中國客運碼頭,出境,0,0,0,0
9/3/2020,二,港口管制,入境,0,0,0,0
9/3/2020,二,港口管制,出境,0,0,0,0
9/3/2020,二,啟德郵輪碼頭,入境,0,0,0,0
9/3/2020,二,啟德郵輪碼頭,出境,0,0,0,0
9/3/2020,二,港澳客輪碼頭,入境,0,0,0,0
9/3/2020,二,港澳客輪碼頭,出境,0,0,0,0
9/3/2020,二,屯門客運碼頭,入境,0,0,0,0
9/3/2020,二,屯門客運碼頭,出境,0,0,0,0
10/3/2020,二,機場,入境,7051,663,1531,9245
10/3/2020,二,機場,出境,3802,142,914,4858
10/3/2020,二,高鐵西九龍,入境,0,0,0,0
10/3/2020,二,高鐵西九龍,出境,0,0,0,0
10/3/2020,二,紅磡,入境,0,0,0,0
10/3/2020,二,紅磡,出境,0,0,0,0
10/3/2020,二,羅湖,入境,0,0,0,0
10/3/2020,二,羅湖,出境,0,0,0,0
10/3/2020,二,落馬洲支線,入境,0,0,0,0
10/3/2020,二,落馬洲支線,出境,0,0,0,0
10/3/2020,二,港珠澳大橋,入境,5366,31,757,6154
10/3/2020,二,港珠澳大橋,出境,5687,84,900,6671
10/3/2020,二,落馬洲,入境,0,0,0,0
10/3/2020,二,落馬洲,出境,0,0,0,0
10/3/2020,二,文錦渡,入境,0,0,0,0
10/3/2020,二,文錦渡,出境,0,0,0,0
10/3/2020,二,沙頭角,入境,0,0,0,0
10/3/2020,二,沙頭角,出境,0,0,0,0
10/3/2020,二,深圳灣,入境,1491,212,5,1708
10/3/2020,二,深圳灣,出境,1762,802,432,2996
10/3/2020,二,中國客運碼頭,入境,0,0,0,0
10/3/2020,二,中國客運碼頭,出境,0,0,0,0
10/3/2020,二,港口管制,入境,0,0,0,0
10/3/2020,二,港口管制,出境,0,0,0,0
10/3/2020,二,啟德郵輪碼頭,入境,0,0,0,0
10/3/2020,二,啟德郵輪碼頭,出境,0,0,0,0
10/3/2020,二,港澳客輪碼頭,入境,0,0,0,0
10/3/2020,二,港澳客輪碼頭,出境,0,0,0,0
10/3/2020,二,屯門客運碼頭,入境,0,0,0,0
10/3/2020,二,屯門客運碼頭,出境,0,0,0,0
11/3/2020,二,機場,入境,7610,838,1539,9987
11/3/2020,二,機場,出境,3443,205,841,4489
11/3/2020,二,高鐵西九龍,入境,0,0,0,0
11/3/2020,二,高鐵西九龍,出境,0,0,0,0
11/3/2020,二,紅磡,入境,0,0,0,0
11/3/2020,二,紅磡,出境,0,0,0,0
11/3/2020,二,羅湖,入境,0,0,0,0
11/3/2020,二,羅湖,出境,0,0,0,0
11/3/2020,二,落馬洲支線,入境,0,0,0,0
11/3/2020,二,落馬洲支線,出境,0,0,0,0
11/3/2020,二,港珠澳大橋,入境,5248,25,733,6006
11/3/2020,二,港珠澳大橋,出境,5258,122,765,6145
11/3/2020,二,落馬洲,入境,0,0,0,0
11/3/2020,二,落馬洲,出境,0,0,0,0
11/3/2020,二,文錦渡,入境,0,0,0,0
11/3/2020,二,文錦渡,出境,0,0,0,0
11/3/2020,二,沙頭角,入境,0,0,0,0
11/3/2020,二,沙頭角,出境,0,0,0,0
11/3/2020,二,深圳灣,入境,1418,244,2,1664
11/3/2020,二,深圳灣,出境,1632,866,443,2941
11/3/2020,二,中國客運碼頭,入境,0,0,0,0
11/3/2020,二,中國客運碼頭,出境,0,0,0,0
11/3/2020,二,港口管制,入境,0,0,0,0
11/3/2020,二,港口管制,出境,0,0,0,0
11/3/2020,二,啟德郵輪碼頭,入境,0,0,0,0
11/3/2020,二,啟德郵輪碼頭,出境,0,0,0,0
11/3/2020,二,港澳客輪碼頭,入境,0,0,0,0
11/3/2020,二,港澳客輪碼頭,出境,0,0,0,0
11/3/2020,二,屯門客運碼頭,入境,0,0,0,0
11/3/2020,二,屯門客運碼頭,出境,0,0,0,0
12/3/2020,二,機場,入境,6416,944,1426,8786
12/3/2020,二,機場,出境,4050,152,995,5197
12/3/2020,二,高鐵西九龍,入境,0,0,0,0
12/3/2020,二,高鐵西九龍,出境,0,0,0,0
12/3/2020,二,紅磡,入境,0,0,0,0
12/3/2020,二,紅磡,出境,0,0,0,0
12/3/2020,二,羅湖,入境,0,0,0,0
12/3/2020,二,羅湖,出境,0,0,0,0
12/3/2020,二,落馬洲支線,入境,0,0,0,0
12/3/2020,二,落馬洲支線,出境,0,0,0,0
12/3/2020,二,港珠澳大橋,入境,5391,21,753,6165
12/3/2020,二,港珠澳大橋,出境,5753,177,790,6720
12/3/2020,二,落馬洲,入境,0,0,0,0
12/3/2020,二,落馬洲,出境,0,0,0,0
12/3/2020,二,文錦渡,入境,0,0,0,0
12/3/2020,二,文錦渡,出境,0,0,0,0
12/3/2020,二,沙頭角,入境,0,0,0,0
12/3/2020,二,沙頭角,出境,0,0,0,0
12/3/2020,二,深圳灣,入境,1376,235,3,1614
12/3/2020,二,深圳灣,出境,1602,887,417,2906
12/3/2020,二,中國客運碼頭,入境,0,0,0,0
12/3/2020,二,中國客運碼頭,出境,0,0,0,0
12/3/2020,二,港口管制,入境,0,0,0,0
12/3/2020,二,港口管制,出境,0,0,0,0
12/3/2020,二,啟德郵輪碼頭,入境,0,0,0,0
12/3/2020,二,啟德郵輪碼頭,出境,0,0,0,0
12/3/2020,二,港澳客輪碼頭,入境,0,0,0,0
12/3/2020,二,港澳客輪碼頭,出境,0,0,0,0
12/3/2020,二,屯門客運碼頭,入境,0,0,0,0
12/3/2020,二,屯門客運碼頭,出境,0,0,0,0
13/3/2020,二,機場,入境,6758,1075,1401,9234
13/3/2020,二,機場,出境,4435,269,1044,5748
13/3/2020,二,高鐵西九龍,入境,0,0,0,0
13/3/2020,二,高鐵西九龍,出境,0,0,0,0
13/3/2020,二,紅磡,入境,0,0,0,0
13/3/2020,二,紅磡,出境,0,0,0,0
13/3/2020,二,羅湖,入境,0,0,0,0
13/3/2020,二,羅湖,出境,0,0,0,0
13/3/2020,二,落馬洲支線,入境,0,0,0,0
13/3/2020,二,落馬洲支線,出境,0,0,0,0
13/3/2020,二,港珠澳大橋,入境,6872,19,945,7836
13/3/2020,二,港珠澳大橋,出境,6694,142,939,7775
13/3/2020,二,落馬洲,入境,0,0,0,0
13/3/2020,二,落馬洲,出境,0,0,0,0
13/3/2020,二,文錦渡,入境,0,0,0,0
13/3/2020,二,文錦渡,出境,0,0,0,0
13/3/2020,二,沙頭角,入境,0,0,0,0
13/3/2020,二,沙頭角,出境,0,0,0,0
13/3/2020,二,深圳灣,入境,1418,254,3,1675
13/3/2020,二,深圳灣,出境,1520,1018,369,2907
13/3/2020,二,中國客運碼頭,入境,0,0,0,0
13/3/2020,二,中國客運碼頭,出境,0,0,0,0
13/3/2020,二,港口管制,入境,0,0,0,0
13/3/2020,二,港口管制,出境,0,0,0,0
13/3/2020,二,啟德郵輪碼頭,入境,0,0,0,0
13/3/2020,二,啟德郵輪碼頭,出境,0,0,0,0
13/3/2020,二,港澳客輪碼頭,入境,0,0,0,0
13/3/2020,二,港澳客輪碼頭,出境,0,0,0,0
13/3/2020,二,屯門客運碼頭,入境,0,0,0,0
13/3/2020,二,屯門客運碼頭,出境,0,0,0,0
14/3/2020,二,機場,入境,7513,1435,1587,10535
14/3/2020,二,機場,出境,3764,214,996,4974
14/3/2020,二,高鐵西九龍,入境,0,0,0,0
14/3/2020,二,高鐵西九龍,出境,0,0,0,0
14/3/2020,二,紅磡,入境,0,0,0,0
14/3/2020,二,紅磡,出境,0,0,0,0
14/3/2020,二,羅湖,入境,0,0,0,0
14/3/2020,二,羅湖,出境,0,0,0,0
14/3/2020,二,落馬洲支線,入境,0,0,0,0
14/3/2020,二,落馬洲支線,出境,0,0,0,0
14/3/2020,二,港珠澳大橋,入境,6098,25,1075,7198
14/3/2020,二,港珠澳大橋,出境,7110,206,1126,8442
14/3/2020,二,落馬洲,入境,0,0,0,0
14/3/2020,二,落馬洲,出境,0,0,0,0
14/3/2020,二,文錦渡,入境,0,0,0,0
14/3/2020,二,文錦渡,出境,0,0,0,0
14/3/2020,二,沙頭角,入境,0,0,0,0
14/3/2020,二,沙頭角,出境,0,0,0,0
14/3/2020,二,深圳灣,入境,1276,270,3,1549
14/3/2020,二,深圳灣,出境,1560,1303,406,3269
14/3/2020,二,中國客運碼頭,入境,0,0,0,0
14/3/2020,二,中國客運碼頭,出境,0,0,0,0
14/3/2020,二,港口管制,入境,0,0,0,0
14/3/2020,二,港口管制,出境,0,0,0,0
14/3/2020,二,啟德郵輪碼頭,入境,0,0,0,0
14/3/2020,二,啟德郵輪碼頭,出境,0,0,0,0
14/3/2020,二,港澳客輪碼頭,入境,0,0,0,0
14/3/2020,二,港澳客輪碼頭,出境,0,0,0,0
14/3/2020,二,屯門客運碼頭,入境,0,0,0,0
14/3/2020,二,屯門客運碼頭,出境,0,0,0,0
15/3/2020,二,機場,入境,10027,1558,1950,13535
15/3/2020,二,機場,出境,2516,315,863,3694
15/3/2020,二,高鐵西九龍,入境,0,0,0,0
15/3/2020,二,高鐵西九龍,出境,0,0,0,0
15/3/2020,二,紅磡,入境,0,0,0,0
15/3/2020,二,紅磡,出境,0,0,0,0
15/3/2020,二,羅湖,入境,0,0,0,0
15/3/2020,二,羅湖,出境,0,0,0,0
15/3/2020,二,落馬洲支線,入境,0,0,0,0
15/3/2020,二,落馬洲支線,出境,0,0,0,0
15/3/2020,二,港珠澳大橋,入境,8172,33,674,8879
15/3/2020,二,港珠澳大橋,出境,7405,194,1233,8832
15/3/2020,二,落馬洲,入境,0,0,0,0
15/3/2020,二,落馬洲,出境,0,0,0,0
15/3/2020,二,文錦渡,入境,0,0,0,0
15/3/2020,二,文錦渡,出境,0,0,0,0
15/3/2020,二,沙頭角,入境,0,0,0,0
15/3/2020,二,沙頭角,出境,0,0,0,0
15/3/2020,二,深圳灣,入境,1745,351,18,2114
15/3/2020,二,深圳灣,出境,1628,1565,632,3825
15/3/2020,二,中國客運碼頭,入境,0,0,0,0
15/3/2020,二,中國客運碼頭,出境,0,0,0,0
15/3/2020,二,港口管制,入境,0,0,0,0
15/3/2020,二,港口管制,出境,0,0,0,0
15/3/2020,二,啟德郵輪碼頭,入境,0,0,0,0
15/3/2020,二,啟德郵輪碼頭,出境,0,0,0,0
15/3/2020,二,港澳客輪碼頭,入境,0,0,0,0
15/3/2020,二,港澳客輪碼頭,出境,0,0,0,0
15/3/2020,二,屯門客運碼頭,入境,0,0,0,0
15/3/2020,二,屯門客運碼頭,出境,0,0,0,0
16/3/2020,二,機場,入境,8498,1662,2038,12198
16/3/2020,二,機場,出境,2117,382,896,3395
16/3/2020,二,高鐵西九龍,入境,0,0,0,0
16/3/2020,二,高鐵西九龍,出境,0,0,0,0
16/3/2020,二,紅磡,入境,0,0,0,0
16/3/2020,二,紅磡,出境,0,0,0,0
16/3/2020,二,羅湖,入境,0,0,0,0
16/3/2020,二,羅湖,出境,0,0,0,0
16/3/2020,二,落馬洲支線,入境,0,0,0,0
16/3/2020,二,落馬洲支線,出境,0,0,0,0
16/3/2020,二,港珠澳大橋,入境,6258,28,792,7078
16/3/2020,二,港珠澳大橋,出境,6782,314,1408,8504
16/3/2020,二,落馬洲,入境,0,0,0,0
16/3/2020,二,落馬洲,出境,0,0,0,0
16/3/2020,二,文錦渡,入境,0,0,0,0
16/3/2020,二,文錦渡,出境,0,0,0,0
16/3/2020,二,沙頭角,入境,0,0,0,0
16/3/2020,二,沙頭角,出境,0,0,0,0
16/3/2020,二,深圳灣,入境,1878,326,8,2212
16/3/2020,二,深圳灣,出境,2182,1450,593,4225
16/3/2020,二,中國客運碼頭,入境,0,0,0,0
16/3/2020,二,中國客運碼頭,出境,0,0,0,0
16/3/2020,二,港口管制,入境,0,0,0,0
16/3/2020,二,港口管制,出境,0,0,0,0
16/3/2020,二,啟德郵輪碼頭,入境,0,0,0,0
16/3/2020,二,啟德郵輪碼頭,出境,0,0,0,0
16/3/2020,二,港澳客輪碼頭,入境,0,0,0,0
16/3/2020,二,港澳客輪碼頭,出境,0,0,0,0
16/3/2020,二,屯門客運碼頭,入境,0,0,0,0
16/3/2020,二,屯門客運碼頭,出境,0,0,0,0
17/3/2020,二,機場,入境,7472,1702,1272,10446
17/3/2020,二,機場,出境,1483,339,666,2488
17/3/2020,二,高鐵西九龍,入境,0,0,0,0
17/3/2020,二,高鐵西九龍,出境,0,0,0,0
17/3/2020,二,紅磡,入境,0,0,0,0
17/3/2020,二,紅磡,出境,0,0,0,0
17/3/2020,二,羅湖,入境,0,0,0,0
17/3/2020,二,羅湖,出境,0,0,0,0
17/3/2020,二,落馬洲支線,入境,0,0,0,0
17/3/2020,二,落馬洲支線,出境,0,0,0,0
17/3/2020,二,港珠澳大橋,入境,5812,21,753,6586
17/3/2020,二,港珠澳大橋,出境,5791,287,979,7057
17/3/2020,二,落馬洲,入境,0,0,0,0
17/3/2020,二,落馬洲,出境,0,0,0,0
17/3/2020,二,文錦渡,入境,0,0,0,0
17/3/2020,二,文錦渡,出境,0,0,0,0
17/3/2020,二,沙頭角,入境,0,0,0,0
17/3/2020,二,沙頭角,出境,0,0,0,0
17/3/2020,二,深圳灣,入境,1393,257,4,1654
17/3/2020,二,深圳灣,出境,1672,1420,446,3538
17/3/2020,二,中國客運碼頭,入境,0,0,0,0
17/3/2020,二,中國客運碼頭,出境,0,0,0,0
17/3/2020,二,港口管制,入境,0,0,0,0
17/3/2020,二,港口管制,出境,0,0,0,0
17/3/2020,二,啟德郵輪碼頭,入境,0,0,0,0
17/3/2020,二,啟德郵輪碼頭,出境,0,0,0,0
17/3/2020,二,港澳客輪碼頭,入境,0,0,0,0
17/3/2020,二,港澳客輪碼頭,出境,0,0,0,0
17/3/2020,二,屯門客運碼頭,入境,0,0,0,0
17/3/2020,二,屯門客運碼頭,出境,0,0,0,0
18/3/2020,二,機場,入境,9616,2027,1309,12952
18/3/2020,二,機場,出境,1041,337,615,1993
18/3/2020,二,高鐵西九龍,入境,0,0,0,0
18/3/2020,二,高鐵西九龍,出境,0,0,0,0
18/3/2020,二,紅磡,入境,0,0,0,0
18/3/2020,二,紅磡,出境,0,0,0,0
18/3/2020,二,羅湖,入境,0,0,0,0
18/3/2020,二,羅湖,出境,0,0,0,0
18/3/2020,二,落馬洲支線,入境,0,0,0,0
18/3/2020,二,落馬洲支線,出境,0,0,0,0
18/3/2020,二,港珠澳大橋,入境,5266,37,580,5883
18/3/2020,二,港珠澳大橋,出境,4850,334,792,5976
18/3/2020,二,落馬洲,入境,0,0,0,0
18/3/2020,二,落馬洲,出境,0,0,0,0
18/3/2020,二,文錦渡,入境,0,0,0,0
18/3/2020,二,文錦渡,出境,0,0,0,0
18/3/2020,二,沙頭角,入境,0,0,0,0
18/3/2020,二,沙頭角,出境,0,0,0,0
18/3/2020,二,深圳灣,入境,1394,344,10,1748
18/3/2020,二,深圳灣,出境,1570,1734,360,3664
18/3/2020,二,中國客運碼頭,入境,0,0,0,0
18/3/2020,二,中國客運碼頭,出境,0,0,0,0
18/3/2020,二,港口管制,入境,0,0,0,0
18/3/2020,二,港口管制,出境,0,0,0,0
18/3/2020,二,啟德郵輪碼頭,入境,0,0,0,0
18/3/2020,二,啟德郵輪碼頭,出境,0,0,0,0
18/3/2020,二,港澳客輪碼頭,入境,0,0,0,0
18/3/2020,二,港澳客輪碼頭,出境,0,0,0,0
18/3/2020,二,屯門客運碼頭,入境,0,0,0,0
18/3/2020,二,屯門客運碼頭,出境,0,0,0,0
19/3/2020,二,機場,入境,6138,37,596,6771
19/3/2020,二,機場,出境,1110,160,519,1789
19/3/2020,二,高鐵西九龍,入境,0,0,0,0
19/3/2020,二,高鐵西九龍,出境,0,0,0,0
19/3/2020,二,紅磡,入境,0,0,0,0
19/3/2020,二,紅磡,出境,0,0,0,0
19/3/2020,二,羅湖,入境,0,0,0,0
19/3/2020,二,羅湖,出境,0,0,0,0
19/3/2020,二,落馬洲支線,入境,0,0,0,0
19/3/2020,二,落馬洲支線,出境,0,0,0,0
19/3/2020,二,港珠澳大橋,入境,4687,22,352,5061
19/3/2020,二,港珠澳大橋,出境,4824,46,423,5293
19/3/2020,二,落馬洲,入境,0,0,0,0
19/3/2020,二,落馬洲,出境,0,0,0,0
19/3/2020,二,文錦渡,入境,0,0,0,0
19/3/2020,二,文錦渡,出境,0,0,0,0
19/3/2020,二,沙頭角,入境,0,0,0,0
19/3/2020,二,沙頭角,出境,0,0,0,0
19/3/2020,二,深圳灣,入境,1099,184,3,1286
19/3/2020,二,深圳灣,出境,1449,458,244,2151
19/3/2020,二,中國客運碼頭,入境,0,0,0,0
19/3/2020,二,中國客運碼頭,出境,0,0,0,0
19/3/2020,二,港口管制,入境,0,0,0,0
19/3/2020,二,港口管制,出境,0,0,0,0
19/3/2020,二,啟德郵輪碼頭,入境,0,0,0,0
19/3/2020,二,啟德郵輪碼頭,出境,0,0,0,0
19/3/2020,二,港澳客輪碼頭,入境,0,0,0,0
19/3/2020,二,港澳客輪碼頭,出境,0,0,0,0
19/3/2020,二,屯門客運碼頭,入境,0,0,0,0
19/3/2020,二,屯門客運碼頭,出境,0,0,0,0
20/3/2020,二,機場,入境,6427,44,603,7074
20/3/2020,二,機場,出境,1190,54,445,1689
20/3/2020,二,高鐵西九龍,入境,0,0,0,0
20/3/2020,二,高鐵西九龍,出境,0,0,0,0
20/3/2020,二,紅磡,入境,0,0,0,0
20/3/2020,二,紅磡,出境,0,0,0,0
20/3/2020,二,羅湖,入境,0,0,0,0
20/3/2020,二,羅湖,出境,0,0,0,0
20/3/2020,二,落馬洲支線,入境,0,0,0,0
20/3/2020,二,落馬洲支線,出境,0,0,0,0
20/3/2020,二,港珠澳大橋,入境,5732,18,458,6208
20/3/2020,二,港珠澳大橋,出境,5426,48,691,6165
20/3/2020,二,落馬洲,入境,0,0,0,0
20/3/2020,二,落馬洲,出境,0,0,0,0
20/3/2020,二,文錦渡,入境,0,0,0,0
20/3/2020,二,文錦渡,出境,0,0,0,0
20/3/2020,二,沙頭角,入境,0,0,0,0
20/3/2020,二,沙頭角,出境,0,0,0,0
20/3/2020,二,深圳灣,入境,1328,245,3,1576
20/3/2020,二,深圳灣,出境,1404,401,176,1981
20/3/2020,二,中國客運碼頭,入境,0,0,0,0
20/3/2020,二,中國客運碼頭,出境,0,0,0,0
20/3/2020,二,港口管制,入境,0,0,0,0
20/3/2020,二,港口管制,出境,0,0,0,0
20/3/2020,二,啟德郵輪碼頭,入境,0,0,0,0
20/3/2020,二,啟德郵輪碼頭,出境,0,0,0,0
20/3/2020,二,港澳客輪碼頭,入境,0,0,0,0
20/3/2020,二,港澳客輪碼頭,出境,0,0,0,0
20/3/2020,二,屯門客運碼頭,入境,0,0,0,0
20/3/2020,二,屯門客運碼頭,出境,0,0,0,0
21/3/2020,二,機場,入境,6547,43,526,7116
21/3/2020,二,機場,出境,844,39,320,1203
21/3/2020,二,高鐵西九龍,入境,0,0,0,0
21/3/2020,二,高鐵西九龍,出境,0,0,0,0
21/3/2020,二,紅磡,入境,0,0,0,0
21/3/2020,二,紅磡,出境,0,0,0,0
21/3/2020,二,羅湖,入境,0,0,0,0
21/3/2020,二,羅湖,出境,0,0,0,0
21/3/2020,二,落馬洲支線,入境,0,0,0,0
21/3/2020,二,落馬洲支線,出境,0,0,0,0
21/3/2020,二,港珠澳大橋,入境,4805,37,388,5230
21/3/2020,二,港珠澳大橋,出境,5244,70,536,5850
21/3/2020,二,落馬洲,入境,0,0,0,0
21/3/2020,二,落馬洲,出境,0,0,0,0
21/3/2020,二,文錦渡,入境,0,0,0,0
21/3/2020,二,文錦渡,出境,0,0,0,0
21/3/2020,二,沙頭角,入境,0,0,0,0
21/3/2020,二,沙頭角,出境,0,0,0,0
21/3/2020,二,深圳灣,入境,904,239,5,1148
21/3/2020,二,深圳灣,出境,1384,457,113,1954
21/3/2020,二,中國客運碼頭,入境,0,0,0,0
21/3/2020,二,中國客運碼頭,出境,0,0,0,0
21/3/2020,二,港口管制,入境,0,0,0,0
21/3/2020,二,港口管制,出境,0,0,0,0
21/3/2020,二,啟德郵輪碼頭,入境,0,0,0,0
21/3/2020,二,啟德郵輪碼頭,出境,0,0,0,0
21/3/2020,二,港澳客輪碼頭,入境,0,0,0,0
21/3/2020,二,港澳客輪碼頭,出境,0,0,0,0
21/3/2020,二,屯門客運碼頭,入境,0,0,0,0
21/3/2020,二,屯門客運碼頭,出境,0,0,0,0
22/3/2020,二,機場,入境,5596,33,566,6195
22/3/2020,二,機場,出境,659,49,228,936
22/3/2020,二,高鐵西九龍,入境,0,0,0,0
22/3/2020,二,高鐵西九龍,出境,0,0,0,0
22/3/2020,二,紅磡,入境,0,0,0,0
22/3/2020,二,紅磡,出境,0,0,0,0
22/3/2020,二,羅湖,入境,0,0,0,0
22/3/2020,二,羅湖,出境,0,0,0,0
22/3/2020,二,落馬洲支線,入境,0,0,0,0
22/3/2020,二,落馬洲支線,出境,0,0,0,0
22/3/2020,二,港珠澳大橋,入境,4996,31,235,5262
22/3/2020,二,港珠澳大橋,出境,4386,49,453,4888
22/3/2020,二,落馬洲,入境,0,0,0,0
22/3/2020,二,落馬洲,出境,0,0,0,0
22/3/2020,二,文錦渡,入境,0,0,0,0
22/3/2020,二,文錦渡,出境,0,0,0,0
22/3/2020,二,沙頭角,入境,0,0,0,0
22/3/2020,二,沙頭角,出境,0,0,0,0
22/3/2020,二,深圳灣,入境,1064,272,4,1340
22/3/2020,二,深圳灣,出境,1619,567,199,2385
22/3/2020,二,中國客運碼頭,入境,0,0,0,0
22/3/2020,二,中國客運碼頭,出境,0,0,0,0
22/3/2020,二,港口管制,入境,0,0,0,0
22/3/2020,二,港口管制,出境,0,0,0,0
22/3/2020,二,啟德郵輪碼頭,入境,0,0,0,0
22/3/2020,二,啟德郵輪碼頭,出境,0,0,0,0
22/3/2020,二,港澳客輪碼頭,入境,0,0,0,0
22/3/2020,二,港澳客輪碼頭,出境,0,0,0,0
22/3/2020,二,屯門客運碼頭,入境,0,0,0,0
22/3/2020,二,屯門客運碼頭,出境,0,0,0,0
23/3/2020,二,機場,入境,4536,30,529,5095
23/3/2020,二,機場,出境,514,34,208,756
23/3/2020,二,高鐵西九龍,入境,0,0,0,0
23/3/2020,二,高鐵西九龍,出境,0,0,0,0
23/3/2020,二,紅磡,入境,0,0,0,0
23/3/2020,二,紅磡,出境,0,0,0,0
23/3/2020,二,羅湖,入境,0,0,0,0
23/3/2020,二,羅湖,出境,0,0,0,0
23/3/2020,二,落馬洲支線,入境,0,0,0,0
23/3/2020,二,落馬洲支線,出境,0,0,0,0
23/3/2020,二,港珠澳大橋,入境,4930,16,353,5299
23/3/2020,二,港珠澳大橋,出境,5722,43,539,6304
23/3/2020,二,落馬洲,入境,0,0,0,0
23/3/2020,二,落馬洲,出境,0,0,0,0
23/3/2020,二,文錦渡,入境,0,0,0,0
23/3/2020,二,文錦渡,出境,0,0,0,0
23/3/2020,二,沙頭角,入境,0,0,0,0
23/3/2020,二,沙頭角,出境,0,0,0,0
23/3/2020,二,深圳灣,入境,1053,201,4,1258
23/3/2020,二,深圳灣,出境,2229,462,207,2898
23/3/2020,二,中國客運碼頭,入境,0,0,0,0
23/3/2020,二,中國客運碼頭,出境,0,0,0,0
23/3/2020,二,港口管制,入境,0,0,0,0
23/3/2020,二,港口管制,出境,0,0,0,0
23/3/2020,二,啟德郵輪碼頭,入境,0,0,0,0
23/3/2020,二,啟德郵輪碼頭,出境,0,0,0,0
23/3/2020,二,港澳客輪碼頭,入境,0,0,0,0
23/3/2020,二,港澳客輪碼頭,出境,0,0,0,0
23/3/2020,二,屯門客運碼頭,入境,0,0,0,0
23/3/2020,二,屯門客運碼頭,出境,0,0,0,0
24/3/2020,二,機場,入境,3488,73,855,4416
24/3/2020,二,機場,出境,577,21,260,858
24/3/2020,二,高鐵西九龍,入境,0,0,0,0
24/3/2020,二,高鐵西九龍,出境,0,0,0,0
24/3/2020,二,紅磡,入境,0,0,0,0
24/3/2020,二,紅磡,出境,0,0,0,0
24/3/2020,二,羅湖,入境,0,0,0,0
24/3/2020,二,羅湖,出境,0,0,0,0
24/3/2020,二,落馬洲支線,入境,0,0,0,0
24/3/2020,二,落馬洲支線,出境,0,0,0,0
24/3/2020,二,港珠澳大橋,入境,7851,47,942,8840
24/3/2020,二,港珠澳大橋,出境,6050,67,1082,7199
24/3/2020,二,落馬洲,入境,0,0,0,0
24/3/2020,二,落馬洲,出境,0,0,0,0
24/3/2020,二,文錦渡,入境,0,0,0,0
24/3/2020,二,文錦渡,出境,0,0,0,0
24/3/2020,二,沙頭角,入境,0,0,0,0
24/3/2020,二,沙頭角,出境,0,0,0,0
24/3/2020,二,深圳灣,入境,1198,317,12,1527
24/3/2020,二,深圳灣,出境,1793,453,401,2647
24/3/2020,二,中國客運碼頭,入境,0,0,0,0
24/3/2020,二,中國客運碼頭,出境,0,0,0,0
24/3/2020,二,港口管制,入境,0,0,0,0
24/3/2020,二,港口管制,出境,0,0,0,0
24/3/2020,二,啟德郵輪碼頭,入境,0,0,0,0
24/3/2020,二,啟德郵輪碼頭,出境,0,0,0,0
24/3/2020,二,港澳客輪碼頭,入境,0,0,0,0
24/3/2020,二,港澳客輪碼頭,出境,0,0,0,0
24/3/2020,二,屯門客運碼頭,入境,0,0,0,0
24/3/2020,二,屯門客運碼頭,出境,0,0,0,0
25/3/2020,二,機場,入境,4053,6,158,4217
25/3/2020,二,機場,出境,629,21,236,886
25/3/2020,二,高鐵西九龍,入境,0,0,0,0
25/3/2020,二,高鐵西九龍,出境,0,0,0,0
25/3/2020,二,紅磡,入境,0,0,0,0
25/3/2020,二,紅磡,出境,0,0,0,0
25/3/2020,二,羅湖,入境,0,0,0,0
25/3/2020,二,羅湖,出境,0,0,0,0
25/3/2020,二,落馬洲支線,入境,0,0,0,0
25/3/2020,二,落馬洲支線,出境,0,0,0,0
25/3/2020,二,港珠澳大橋,入境,106,7,19,132
25/3/2020,二,港珠澳大橋,出境,212,25,173,410
25/3/2020,二,落馬洲,入境,0,0,0,0
25/3/2020,二,落馬洲,出境,0,0,0,0
25/3/2020,二,文錦渡,入境,0,0,0,0
25/3/2020,二,文錦渡,出境,0,0,0,0
25/3/2020,二,沙頭角,入境,0,0,0,0
25/3/2020,二,沙頭角,出境,0,0,0,0
25/3/2020,二,深圳灣,入境,810,135,3,948
25/3/2020,二,深圳灣,出境,1525,326,21,1872
25/3/2020,二,中國客運碼頭,入境,0,0,0,0
25/3/2020,二,中國客運碼頭,出境,0,0,0,0
25/3/2020,二,港口管制,入境,0,0,0,0
25/3/2020,二,港口管制,出境,0,0,0,0
25/3/2020,二,啟德郵輪碼頭,入境,0,0,0,0
25/3/2020,二,啟德郵輪碼頭,出境,0,0,0,0
25/3/2020,二,港澳客輪碼頭,入境,0,0,0,0
25/3/2020,二,港澳客輪碼頭,出境,0,0,0,0
25/3/2020,二,屯門客運碼頭,入境,0,0,0,0
25/3/2020,二,屯門客運碼頭,出境,0,0,0,0
26/3/2020,二,機場,入境,3303,6,126,3435
26/3/2020,二,機場,出境,436,20,138,594
26/3/2020,二,高鐵西九龍,入境,0,0,0,0
26/3/2020,二,高鐵西九龍,出境,0,0,0,0
26/3/2020,二,紅磡,入境,0,0,0,0
26/3/2020,二,紅磡,出境,0,0,0,0
26/3/2020,二,羅湖,入境,0,0,0,0
26/3/2020,二,羅湖,出境,0,0,0,0
26/3/2020,二,落馬洲支線,入境,0,0,0,0
26/3/2020,二,落馬洲支線,出境,0,0,0,0
26/3/2020,二,港珠澳大橋,入境,95,8,23,126
26/3/2020,二,港珠澳大橋,出境,342,42,113,497
26/3/2020,二,落馬洲,入境,0,0,0,0
26/3/2020,二,落馬洲,出境,0,0,0,0
26/3/2020,二,文錦渡,入境,0,0,0,0
26/3/2020,二,文錦渡,出境,0,0,0,0
26/3/2020,二,沙頭角,入境,0,0,0,0
26/3/2020,二,沙頭角,出境,0,0,0,0
26/3/2020,二,深圳灣,入境,773,122,2,897
26/3/2020,二,深圳灣,出境,2476,522,16,3014
26/3/2020,二,中國客運碼頭,入境,0,0,0,0
26/3/2020,二,中國客運碼頭,出境,0,0,0,0
26/3/2020,二,港口管制,入境,0,0,0,0
26/3/2020,二,港口管制,出境,0,0,0,0
26/3/2020,二,啟德郵輪碼頭,入境,0,0,0,0
26/3/2020,二,啟德郵輪碼頭,出境,0,0,0,0
26/3/2020,二,港澳客輪碼頭,入境,0,0,0,0
26/3/2020,二,港澳客輪碼頭,出境,0,0,0,0
26/3/2020,二,屯門客運碼頭,入境,0,0,0,0
26/3/2020,二,屯門客運碼頭,出境,0,0,0,0
27/3/2020,二,機場,入境,2903,4,178,3085
27/3/2020,二,機場,出境,1030,46,238,1314
27/3/2020,二,高鐵西九龍,入境,0,0,0,0
27/3/2020,二,高鐵西九龍,出境,0,0,0,0
27/3/2020,二,紅磡,入境,0,0,0,0
27/3/2020,二,紅磡,出境,0,0,0,0
27/3/2020,二,羅湖,入境,0,0,0,0
27/3/2020,二,羅湖,出境,0,0,0,0
27/3/2020,二,落馬洲支線,入境,0,0,0,0
27/3/2020,二,落馬洲支線,出境,0,0,0,0
27/3/2020,二,港珠澳大橋,入境,124,9,17,150
27/3/2020,二,港珠澳大橋,出境,697,120,170,987
27/3/2020,二,落馬洲,入境,0,0,0,0
27/3/2020,二,落馬洲,出境,0,0,0,0
27/3/2020,二,文錦渡,入境,0,0,0,0
27/3/2020,二,文錦渡,出境,0,0,0,0
27/3/2020,二,沙頭角,入境,0,0,0,0
27/3/2020,二,沙頭角,出境,0,0,0,0
27/3/2020,二,深圳灣,入境,676,121,1,798
27/3/2020,二,深圳灣,出境,298,83,113,494
27/3/2020,二,中國客運碼頭,入境,0,0,0,0
27/3/2020,二,中國客運碼頭,出境,0,0,0,0
27/3/2020,二,港口管制,入境,0,0,0,0
27/3/2020,二,港口管制,出境,0,0,0,0
27/3/2020,二,啟德郵輪碼頭,入境,0,0,0,0
27/3/2020,二,啟德郵輪碼頭,出境,0,0,0,0
27/3/2020,二,港澳客輪碼頭,入境,0,0,0,0
27/3/2020,二,港澳客輪碼頭,出境,0,0,0,0
27/3/2020,二,屯門客運碼頭,入境,0,0,0,0
27/3/2020,二,屯門客運碼頭,出境,0,0,0,0
28/3/2020,二,機場,入境,3744,7,175,3926
28/3/2020,二,機場,出境,691,51,162,904
28/3/2020,二,高鐵西九龍,入境,0,0,0,0
28/3/2020,二,高鐵西九龍,出境,0,0,0,0
28/3/2020,二,紅磡,入境,0,0,0,0
28/3/2020,二,紅磡,出境,0,0,0,0
28/3/2020,二,羅湖,入境,0,0,0,0
28/3/2020,二,羅湖,出境,0,0,0,0
28/3/2020,二,落馬洲支線,入境,0,0,0,0
28/3/2020,二,落馬洲支線,出境,0,0,0,0
28/3/2020,二,港珠澳大橋,入境,67,7,16,90
28/3/2020,二,港珠澳大橋,出境,45,3,146,194
28/3/2020,二,落馬洲,入境,0,0,0,0
28/3/2020,二,落馬洲,出境,0,0,0,0
28/3/2020,二,文錦渡,入境,0,0,0,0
28/3/2020,二,文錦渡,出境,0,0,0,0
28/3/2020,二,沙頭角,入境,0,0,0,0
28/3/2020,二,沙頭角,出境,0,0,0,0
28/3/2020,二,深圳灣,入境,545,96,5,646
28/3/2020,二,深圳灣,出境,238,102,3,343
28/3/2020,二,中國客運碼頭,入境,0,0,0,0
28/3/2020,二,中國客運碼頭,出境,0,0,0,0
28/3/2020,二,港口管制,入境,0,0,0,0
28/3/2020,二,港口管制,出境,0,0,0,0
28/3/2020,二,啟德郵輪碼頭,入境,0,0,0,0
28/3/2020,二,啟德郵輪碼頭,出境,0,0,0,0
28/3/2020,二,港澳客輪碼頭,入境,0,0,0,0
28/3/2020,二,港澳客輪碼頭,出境,0,0,0,0
28/3/2020,二,屯門客運碼頭,入境,0,0,0,0
28/3/2020,二,屯門客運碼頭,出境,0,0,0,0
29/3/2020,二,機場,入境,2616,6,215,2837
29/3/2020,二,機場,出境,301,25,77,403
29/3/2020,二,高鐵西九龍,入境,0,0,0,0
29/3/2020,二,高鐵西九龍,出境,0,0,0,0
29/3/2020,二,紅磡,入境,0,0,0,0
29/3/2020,二,紅磡,出境,0,0,0,0
29/3/2020,二,羅湖,入境,0,0,0,0
29/3/2020,二,羅湖,出境,0,0,0,0
29/3/2020,二,落馬洲支線,入境,0,0,0,0
29/3/2020,二,落馬洲支線,出境,0,0,0,0
29/3/2020,二,港珠澳大橋,入境,60,7,16,83
29/3/2020,二,港珠澳大橋,出境,36,5,181,222
29/3/2020,二,落馬洲,入境,0,0,0,0
29/3/2020,二,落馬洲,出境,0,0,0,0
29/3/2020,二,文錦渡,入境,0,0,0,0
29/3/2020,二,文錦渡,出境,0,0,0,0
29/3/2020,二,沙頭角,入境,0,0,0,0
29/3/2020,二,沙頭角,出境,0,0,0,0
29/3/2020,二,深圳灣,入境,554,110,0,664
29/3/2020,二,深圳灣,出境,221,67,2,290
29/3/2020,二,中國客運碼頭,入境,0,0,0,0
29/3/2020,二,中國客運碼頭,出境,0,0,0,0
29/3/2020,二,港口管制,入境,0,0,0,0
29/3/2020,二,港口管制,出境,0,0,0,0
29/3/2020,二,啟德郵輪碼頭,入境,0,0,0,0
29/3/2020,二,啟德郵輪碼頭,出境,0,0,0,0
29/3/2020,二,港澳客輪碼頭,入境,0,0,0,0
29/3/2020,二,港澳客輪碼頭,出境,0,0,0,0
29/3/2020,二,屯門客運碼頭,入境,0,0,0,0
29/3/2020,二,屯門客運碼頭,出境,0,0,0,0
30/3/2020,二,機場,入境,1924,7,138,2069
30/3/2020,二,機場,出境,346,10,92,448
30/3/2020,二,高鐵西九龍,入境,0,0,0,0
30/3/2020,二,高鐵西九龍,出境,0,0,0,0
30/3/2020,二,紅磡,入境,0,0,0,0
30/3/2020,二,紅磡,出境,0,0,0,0
30/3/2020,二,羅湖,入境,0,0,0,0
30/3/2020,二,羅湖,出境,0,0,0,0
30/3/2020,二,落馬洲支線,入境,0,0,0,0
30/3/2020,二,落馬洲支線,出境,0,0,0,0
30/3/2020,二,港珠澳大橋,入境,60,4,16,80
30/3/2020,二,港珠澳大橋,出境,50,4,145,199
30/3/2020,二,落馬洲,入境,0,0,0,0
30/3/2020,二,落馬洲,出境,0,0,0,0
30/3/2020,二,文錦渡,入境,0,0,0,0
30/3/2020,二,文錦渡,出境,0,0,0,0
30/3/2020,二,沙頭角,入境,0,0,0,0
30/3/2020,二,沙頭角,出境,0,0,0,0
30/3/2020,二,深圳灣,入境,704,79,1,784
30/3/2020,二,深圳灣,出境,284,82,4,370
30/3/2020,二,中國客運碼頭,入境,0,0,0,0
30/3/2020,二,中國客運碼頭,出境,0,0,0,0
30/3/2020,二,港口管制,入境,0,0,0,0
30/3/2020,二,港口管制,出境,0,0,0,0
30/3/2020,二,啟德郵輪碼頭,入境,0,0,0,0
30/3/2020,二,啟德郵輪碼頭,出境,0,0,0,0
30/3/2020,二,港澳客輪碼頭,入境,0,0,0,0
30/3/2020,二,港澳客輪碼頭,出境,0,0,0,0
30/3/2020,二,屯門客運碼頭,入境,0,0,0,0
30/3/2020,二,屯門客運碼頭,出境,0,0,0,0
31/3/2020,二,機場,入境,1406,9,119,1534
31/3/2020,二,機場,出境,569,20,142,731
31/3/2020,二,高鐵西九龍,入境,0,0,0,0
31/3/2020,二,高鐵西九龍,出境,0,0,0,0
31/3/2020,二,紅磡,入境,0,0,0,0
31/3/2020,二,紅磡,出境,0,0,0,0
31/3/2020,二,羅湖,入境,0,0,0,0
31/3/2020,二,羅湖,出境,0,0,0,0
31/3/2020,二,落馬洲支線,入境,0,0,0,0
31/3/2020,二,落馬洲支線,出境,0,0,0,0
31/3/2020,二,港珠澳大橋,入境,76,5,17,98
31/3/2020,二,港珠澳大橋,出境,56,6,122,184
31/3/2020,二,落馬洲,入境,0,0,0,0
31/3/2020,二,落馬洲,出境,0,0,0,0
31/3/2020,二,文錦渡,入境,0,0,0,0
31/3/2020,二,文錦渡,出境,0,0,0,0
31/3/2020,二,沙頭角,入境,0,0,0,0
31/3/2020,二,沙頭角,出境,0,0,0,0
31/3/2020,二,深圳灣,入境,763,97,3,863
31/3/2020,二,深圳灣,出境,366,67,3,436
31/3/2020,二,中國客運碼頭,入境,0,0,0,0
31/3/2020,二,中國客運碼頭,出境,0,0,0,0
31/3/2020,二,港口管制,入境,0,0,0,0
31/3/2020,二,港口管制,出境,0,0,0,0
31/3/2020,二,啟德郵輪碼頭,入境,0,0,0,0
31/3/2020,二,啟德郵輪碼頭,出境,0,0,0,0
31/3/2020,二,港澳客輪碼頭,入境,0,0,0,0
31/3/2020,二,港澳客輪碼頭,出境,0,0,0,0
31/3/2020,二,屯門客運碼頭,入境,0,0,0,0
31/3/2020,二,屯門客運碼頭,出境,0,0,0,0
1/4/2020,二,機場,入境,1144,5,34,1183
1/4/2020,二,機場,出境,526,36,86,648
1/4/2020,二,高鐵西九龍,入境,0,0,0,0
1/4/2020,二,高鐵西九龍,出境,0,0,0,0
1/4/2020,二,紅磡,入境,0,0,0,0
1/4/2020,二,紅磡,出境,0,0,0,0
1/4/2020,二,羅湖,入境,0,0,0,0
1/4/2020,二,羅湖,出境,0,0,0,0
1/4/2020,二,落馬洲支線,入境,0,0,0,0
1/4/2020,二,落馬洲支線,出境,0,0,0,0
1/4/2020,二,港珠澳大橋,入境,68,7,4,79
1/4/2020,二,港珠澳大橋,出境,42,4,16,62
1/4/2020,二,落馬洲,入境,0,0,0,0
1/4/2020,二,落馬洲,出境,0,0,0,0
1/4/2020,二,文錦渡,入境,0,0,0,0
1/4/2020,二,文錦渡,出境,0,0,0,0
1/4/2020,二,沙頭角,入境,0,0,0,0
1/4/2020,二,沙頭角,出境,0,0,0,0
1/4/2020,二,深圳灣,入境,798,84,2,884
1/4/2020,二,深圳灣,出境,385,123,0,508
1/4/2020,二,中國客運碼頭,入境,0,0,0,0
1/4/2020,二,中國客運碼頭,出境,0,0,0,0
1/4/2020,二,港口管制,入境,0,0,0,0
1/4/2020,二,港口管制,出境,0,0,0,0
1/4/2020,二,啟德郵輪碼頭,入境,0,0,0,0
1/4/2020,二,啟德郵輪碼頭,出境,0,0,0,0
1/4/2020,二,港澳客輪碼頭,入境,0,0,0,0
1/4/2020,二,港澳客輪碼頭,出境,0,0,0,0
1/4/2020,二,屯門客運碼頭,入境,0,0,0,0
1/4/2020,二,屯門客運碼頭,出境,0,0,0,0
2/4/2020,二,機場,入境,662,4,9,675
2/4/2020,二,機場,出境,269,21,59,349
2/4/2020,二,高鐵西九龍,入境,0,0,0,0
2/4/2020,二,高鐵西九龍,出境,0,0,0,0
2/4/2020,二,紅磡,入境,0,0,0,0
2/4/2020,二,紅磡,出境,0,0,0,0
2/4/2020,二,羅湖,入境,0,0,0,0
2/4/2020,二,羅湖,出境,0,0,0,0
2/4/2020,二,落馬洲支線,入境,0,0,0,0
2/4/2020,二,落馬洲支線,出境,0,0,0,0
2/4/2020,二,港珠澳大橋,入境,67,3,0,70
2/4/2020,二,港珠澳大橋,出境,70,0,6,76
2/4/2020,二,落馬洲,入境,0,0,0,0
2/4/2020,二,落馬洲,出境,0,0,0,0
2/4/2020,二,文錦渡,入境,0,0,0,0
2/4/2020,二,文錦渡,出境,0,0,0,0
2/4/2020,二,沙頭角,入境,0,0,0,0
2/4/2020,二,沙頭角,出境,0,0,0,0
2/4/2020,二,深圳灣,入境,631,69,0,700
2/4/2020,二,深圳灣,出境,371,87,7,465
2/4/2020,二,中國客運碼頭,入境,0,0,0,0
2/4/2020,二,中國客運碼頭,出境,0,0,0,0
2/4/2020,二,港口管制,入境,0,0,0,0
2/4/2020,二,港口管制,出境,0,0,0,0
2/4/2020,二,啟德郵輪碼頭,入境,0,0,0,0
2/4/2020,二,啟德郵輪碼頭,出境,0,0,0,0
2/4/2020,二,港澳客輪碼頭,入境,0,0,0,0
2/4/2020,二,港澳客輪碼頭,出境,0,0,0,0
2/4/2020,二,屯門客運碼頭,入境,0,0,0,0
2/4/2020,二,屯門客運碼頭,出境,0,0,0,0
3/4/2020,二,機場,入境,979,6,24,1009
3/4/2020,二,機場,出境,610,38,87,735
3/4/2020,二,高鐵西九龍,入境,0,0,0,0
3/4/2020,二,高鐵西九龍,出境,0,0,0,0
3/4/2020,二,紅磡,入境,0,0,0,0
3/4/2020,二,紅磡,出境,0,0,0,0
3/4/2020,二,羅湖,入境,0,0,0,0
3/4/2020,二,羅湖,出境,0,0,0,0
3/4/2020,二,落馬洲支線,入境,0,0,0,0
3/4/2020,二,落馬洲支線,出境,0,0,0,0
3/4/2020,二,港珠澳大橋,入境,59,6,4,69
3/4/2020,二,港珠澳大橋,出境,59,7,6,72
3/4/2020,二,落馬洲,入境,0,0,0,0
3/4/2020,二,落馬洲,出境,0,0,0,0
3/4/2020,二,文錦渡,入境,0,0,0,0
3/4/2020,二,文錦渡,出境,0,0,0,0
3/4/2020,二,沙頭角,入境,0,0,0,0
3/4/2020,二,沙頭角,出境,0,0,0,0
3/4/2020,二,深圳灣,入境,489,85,0,574
3/4/2020,二,深圳灣,出境,353,96,7,456
3/4/2020,二,中國客運碼頭,入境,0,0,0,0
3/4/2020,二,中國客運碼頭,出境,0,0,0,0
3/4/2020,二,港口管制,入境,0,0,0,0
3/4/2020,二,港口管制,出境,0,0,0,0
3/4/2020,二,啟德郵輪碼頭,入境,0,0,0,0
3/4/2020,二,啟德郵輪碼頭,出境,0,0,0,0
3/4/2020,二,港澳客輪碼頭,入境,0,0,0,0
3/4/2020,二,港澳客輪碼頭,出境,0,0,0,0
3/4/2020,二,屯門客運碼頭,入境,0,0,0,0
3/4/2020,二,屯門客運碼頭,出境,0,0,0,0
4/4/2020,四,機場,入境,812,3,15,830
4/4/2020,四,機場,出境,403,20,51,474
4/4/2020,四,高鐵西九龍,入境,0,0,0,0
4/4/2020,四,高鐵西九龍,出境,0,0,0,0
4/4/2020,四,紅磡,入境,0,0,0,0
4/4/2020,四,紅磡,出境,0,0,0,0
4/4/2020,四,羅湖,入境,0,0,0,0
4/4/2020,四,羅湖,出境,0,0,0,0
4/4/2020,四,落馬洲支線,入境,0,0,0,0
4/4/2020,四,落馬洲支線,出境,0,0,0,0
4/4/2020,四,港珠澳大橋,入境,50,2,3,55
4/4/2020,四,港珠澳大橋,出境,58,6,3,67
4/4/2020,四,落馬洲,入境,0,0,0,0
4/4/2020,四,落馬洲,出境,0,0,0,0
4/4/2020,四,文錦渡,入境,0,0,0,0
4/4/2020,四,文錦渡,出境,0,0,0,0
4/4/2020,四,沙頭角,入境,0,0,0,0
4/4/2020,四,沙頭角,出境,0,0,0,0
4/4/2020,四,深圳灣,入境,344,73,0,417
4/4/2020,四,深圳灣,出境,296,86,5,387
4/4/2020,四,中國客運碼頭,入境,0,0,0,0
4/4/2020,四,中國客運碼頭,出境,0,0,0,0
4/4/2020,四,港口管制,入境,0,0,0,0
4/4/2020,四,港口管制,出境,0,0,0,0
4/4/2020,四,啟德郵輪碼頭,入境,0,0,0,0
4/4/2020,四,啟德郵輪碼頭,出境,0,0,0,0
4/4/2020,四,港澳客輪碼頭,入境,0,0,0,0
4/4/2020,四,港澳客輪碼頭,出境,0,0,0,0
4/4/2020,四,屯門客運碼頭,入境,0,0,0,0
4/4/2020,四,屯門客運碼頭,出境,0,0,0,0
5/4/2020,四,機場,入境,806,0,7,813
5/4/2020,四,機場,出境,284,10,71,365
5/4/2020,四,高鐵西九龍,入境,0,0,0,0
5/4/2020,四,高鐵西九龍,出境,0,0,0,0
5/4/2020,四,紅磡,入境,0,0,0,0
5/4/2020,四,紅磡,出境,0,0,0,0
5/4/2020,四,羅湖,入境,0,0,0,0
5/4/2020,四,羅湖,出境,0,0,0,0
5/4/2020,四,落馬洲支線,入境,0,0,0,0
5/4/2020,四,落馬洲支線,出境,0,0,0,0
5/4/2020,四,港珠澳大橋,入境,226,12,18,256
5/4/2020,四,港珠澳大橋,出境,142,5,18,165
5/4/2020,四,落馬洲,入境,0,0,0,0
5/4/2020,四,落馬洲,出境,0,0,0,0
5/4/2020,四,文錦渡,入境,0,0,0,0
5/4/2020,四,文錦渡,出境,0,0,0,0
5/4/2020,四,沙頭角,入境,0,0,0,0
5/4/2020,四,沙頭角,出境,0,0,0,0
5/4/2020,四,深圳灣,入境,479,100,1,580
5/4/2020,四,深圳灣,出境,267,80,1,348
5/4/2020,四,中國客運碼頭,入境,0,0,0,0
5/4/2020,四,中國客運碼頭,出境,0,0,0,0
5/4/2020,四,港口管制,入境,0,0,0,0
5/4/2020,四,港口管制,出境,0,0,0,0
5/4/2020,四,啟德郵輪碼頭,入境,0,0,0,0
5/4/2020,四,啟德郵輪碼頭,出境,0,0,0,0
5/4/2020,四,港澳客輪碼頭,入境,0,0,0,0
5/4/2020,四,港澳客輪碼頭,出境,0,0,0,0
5/4/2020,四,屯門客運碼頭,入境,0,0,0,0
5/4/2020,四,屯門客運碼頭,出境,0,0,0,0
6/4/2020,四,機場,入境,833,2,13,848
6/4/2020,四,機場,出境,185,13,43,241
6/4/2020,四,高鐵西九龍,入境,0,0,0,0
6/4/2020,四,高鐵西九龍,出境,0,0,0,0
6/4/2020,四,紅磡,入境,0,0,0,0
6/4/2020,四,紅磡,出境,0,0,0,0
6/4/2020,四,羅湖,入境,0,0,0,0
6/4/2020,四,羅湖,出境,0,0,0,0
6/4/2020,四,落馬洲支線,入境,0,0,0,0
6/4/2020,四,落馬洲支線,出境,0,0,0,0
6/4/2020,四,港珠澳大橋,入境,20,7,1,28
6/4/2020,四,港珠澳大橋,出境,27,2,0,29
6/4/2020,四,落馬洲,入境,0,0,0,0
6/4/2020,四,落馬洲,出境,0,0,0,0
6/4/2020,四,文錦渡,入境,0,0,0,0
6/4/2020,四,文錦渡,出境,0,0,0,0
6/4/2020,四,沙頭角,入境,0,0,0,0
6/4/2020,四,沙頭角,出境,0,0,0,0
6/4/2020,四,深圳灣,入境,498,89,2,589
6/4/2020,四,深圳灣,出境,446,72,6,524
6/4/2020,四,中國客運碼頭,入境,0,0,0,0
6/4/2020,四,中國客運碼頭,出境,0,0,0,0
6/4/2020,四,港口管制,入境,0,0,0,0
6/4/2020,四,港口管制,出境,0,0,0,0
6/4/2020,四,啟德郵輪碼頭,入境,0,0,0,0
6/4/2020,四,啟德郵輪碼頭,出境,0,0,0,0
6/4/2020,四,港澳客輪碼頭,入境,0,0,0,0
6/4/2020,四,港澳客輪碼頭,出境,0,0,0,0
6/4/2020,四,屯門客運碼頭,入境,0,0,0,0
6/4/2020,四,屯門客運碼頭,出境,0,0,0,0
7/4/2020,四,機場,入境,347,4,16,367
7/4/2020,四,機場,出境,217,14,43,274
7/4/2020,四,高鐵西九龍,入境,0,0,0,0
7/4/2020,四,高鐵西九龍,出境,0,0,0,0
7/4/2020,四,紅磡,入境,0,0,0,0
7/4/2020,四,紅磡,出境,0,0,0,0
7/4/2020,四,羅湖,入境,0,0,0,0
7/4/2020,四,羅湖,出境,0,0,0,0
7/4/2020,四,落馬洲支線,入境,0,0,0,0
7/4/2020,四,落馬洲支線,出境,0,0,0,0
7/4/2020,四,港珠澳大橋,入境,34,8,0,42
7/4/2020,四,港珠澳大橋,出境,30,5,0,35
7/4/2020,四,落馬洲,入境,0,0,0,0
7/4/2020,四,落馬洲,出境,0,0,0,0
7/4/2020,四,文錦渡,入境,0,0,0,0
7/4/2020,四,文錦渡,出境,0,0,0,0
7/4/2020,四,沙頭角,入境,0,0,0,0
7/4/2020,四,沙頭角,出境,0,0,0,0
7/4/2020,四,深圳灣,入境,511,72,0,583
7/4/2020,四,深圳灣,出境,355,107,7,469
7/4/2020,四,中國客運碼頭,入境,0,0,0,0
7/4/2020,四,中國客運碼頭,出境,0,0,0,0
7/4/2020,四,港口管制,入境,0,0,0,0
7/4/2020,四,港口管制,出境,0,0,0,0
7/4/2020,四,啟德郵輪碼頭,入境,0,0,0,0
7/4/2020,四,啟德郵輪碼頭,出境,0,0,0,0
7/4/2020,四,港澳客輪碼頭,入境,0,0,0,0
7/4/2020,四,港澳客輪碼頭,出境,0,0,0,0
7/4/2020,四,屯門客運碼頭,入境,0,0,0,0
7/4/2020,四,屯門客運碼頭,出境,0,0,0,0
8/4/2020,四,機場,入境,835,6,24,865
8/4/2020,四,機場,出境,361,14,59,434
8/4/2020,四,高鐵西九龍,入境,0,0,0,0
8/4/2020,四,高鐵西九龍,出境,0,0,0,0
8/4/2020,四,紅磡,入境,0,0,0,0
8/4/2020,四,紅磡,出境,0,0,0,0
8/4/2020,四,羅湖,入境,0,0,0,0
8/4/2020,四,羅湖,出境,0,0,0,0
8/4/2020,四,落馬洲支線,入境,0,0,0,0
8/4/2020,四,落馬洲支線,出境,0,0,0,0
8/4/2020,四,港珠澳大橋,入境,24,3,0,27
8/4/2020,四,港珠澳大橋,出境,24,2,1,27
8/4/2020,四,落馬洲,入境,0,0,0,0
8/4/2020,四,落馬洲,出境,0,0,0,0
8/4/2020,四,文錦渡,入境,0,0,0,0
8/4/2020,四,文錦渡,出境,0,0,0,0
8/4/2020,四,沙頭角,入境,0,0,0,0
8/4/2020,四,沙頭角,出境,0,0,0,0
8/4/2020,四,深圳灣,入境,587,96,1,684
8/4/2020,四,深圳灣,出境,314,77,3,394
8/4/2020,四,中國客運碼頭,入境,0,0,0,0
8/4/2020,四,中國客運碼頭,出境,0,0,0,0
8/4/2020,四,港口管制,入境,0,0,0,0
8/4/2020,四,港口管制,出境,0,0,0,0
8/4/2020,四,啟德郵輪碼頭,入境,0,0,0,0
8/4/2020,四,啟德郵輪碼頭,出境,0,0,0,0
8/4/2020,四,港澳客輪碼頭,入境,0,0,0,0
8/4/2020,四,港澳客輪碼頭,出境,0,0,0,0
8/4/2020,四,屯門客運碼頭,入境,0,0,0,0
8/4/2020,四,屯門客運碼頭,出境,0,0,0,0
9/4/2020,四,機場,入境,439,0,17,456
9/4/2020,四,機場,出境,189,3,39,231
9/4/2020,四,高鐵西九龍,入境,0,0,0,0
9/4/2020,四,高鐵西九龍,出境,0,0,0,0
9/4/2020,四,紅磡,入境,0,0,0,0
9/4/2020,四,紅磡,出境,0,0,0,0
9/4/2020,四,羅湖,入境,0,0,0,0
9/4/2020,四,羅湖,出境,0,0,0,0
9/4/2020,四,落馬洲支線,入境,0,0,0,0
9/4/2020,四,落馬洲支線,出境,0,0,0,0
9/4/2020,四,港珠澳大橋,入境,33,8,0,41
9/4/2020,四,港珠澳大橋,出境,16,7,2,25
9/4/2020,四,落馬洲,入境,0,0,0,0
9/4/2020,四,落馬洲,出境,0,0,0,0
9/4/2020,四,文錦渡,入境,0,0,0,0
9/4/2020,四,文錦渡,出境,0,0,0,0
9/4/2020,四,沙頭角,入境,0,0,0,0
9/4/2020,四,沙頭角,出境,0,0,0,0
9/4/2020,四,深圳灣,入境,584,85,1,670
9/4/2020,四,深圳灣,出境,349,122,3,474
9/4/2020,四,中國客運碼頭,入境,0,0,0,0
9/4/2020,四,中國客運碼頭,出境,0,0,0,0
9/4/2020,四,港口管制,入境,0,0,0,0
9/4/2020,四,港口管制,出境,0,0,0,0
9/4/2020,四,啟德郵輪碼頭,入境,0,0,0,0
9/4/2020,四,啟德郵輪碼頭,出境,0,0,0,0
9/4/2020,四,港澳客輪碼頭,入境,0,0,0,0
9/4/2020,四,港澳客輪碼頭,出境,0,0,0,0
9/4/2020,四,屯門客運碼頭,入境,0,0,0,0
9/4/2020,四,屯門客運碼頭,出境,0,0,0,0
10/4/2020,三,機場,入境,811,9,39,859
10/4/2020,三,機場,出境,503,20,74,597
10/4/2020,三,高鐵西九龍,入境,0,0,0,0
10/4/2020,三,高鐵西九龍,出境,0,0,0,0
10/4/2020,三,紅磡,入境,0,0,0,0
10/4/2020,三,紅磡,出境,0,0,0,0
10/4/2020,三,羅湖,入境,0,0,0,0
10/4/2020,三,羅湖,出境,0,0,0,0
10/4/2020,三,落馬洲支線,入境,0,0,0,0
10/4/2020,三,落馬洲支線,出境,0,0,0,0
10/4/2020,三,港珠澳大橋,入境,36,6,0,42
10/4/2020,三,港珠澳大橋,出境,16,3,3,22
10/4/2020,三,落馬洲,入境,0,0,0,0
10/4/2020,三,落馬洲,出境,0,0,0,0
10/4/2020,三,文錦渡,入境,0,0,0,0
10/4/2020,三,文錦渡,出境,0,0,0,0
10/4/2020,三,沙頭角,入境,0,0,0,0
10/4/2020,三,沙頭角,出境,0,0,0,0
10/4/2020,三,深圳灣,入境,613,131,1,745
10/4/2020,三,深圳灣,出境,397,129,1,527
10/4/2020,三,中國客運碼頭,入境,0,0,0,0
10/4/2020,三,中國客運碼頭,出境,0,0,0,0
10/4/2020,三,港口管制,入境,0,0,0,0
10/4/2020,三,港口管制,出境,0,0,0,0
10/4/2020,三,啟德郵輪碼頭,入境,0,0,0,0
10/4/2020,三,啟德郵輪碼頭,出境,0,0,0,0
10/4/2020,三,港澳客輪碼頭,入境,0,0,0,0
10/4/2020,三,港澳客輪碼頭,出境,0,0,0,0
10/4/2020,三,屯門客運碼頭,入境,0,0,0,0
10/4/2020,三,屯門客運碼頭,出境,0,0,0,0
11/4/2020,三,機場,入境,220,0,8,228
11/4/2020,三,機場,出境,195,4,33,232
11/4/2020,三,高鐵西九龍,入境,0,0,0,0
11/4/2020,三,高鐵西九龍,出境,0,0,0,0
11/4/2020,三,紅磡,入境,0,0,0,0
11/4/2020,三,紅磡,出境,0,0,0,0
11/4/2020,三,羅湖,入境,0,0,0,0
11/4/2020,三,羅湖,出境,0,0,0,0
11/4/2020,三,落馬洲支線,入境,0,0,0,0
11/4/2020,三,落馬洲支線,出境,0,0,0,0
11/4/2020,三,港珠澳大橋,入境,22,9,4,35
11/4/2020,三,港珠澳大橋,出境,23,2,2,27
11/4/2020,三,落馬洲,入境,0,0,0,0
11/4/2020,三,落馬洲,出境,0,0,0,0
11/4/2020,三,文錦渡,入境,0,0,0,0
11/4/2020,三,文錦渡,出境,0,0,0,0
11/4/2020,三,沙頭角,入境,0,0,0,0
11/4/2020,三,沙頭角,出境,0,0,0,0
11/4/2020,三,深圳灣,入境,590,102,5,697
11/4/2020,三,深圳灣,出境,306,58,2,366
11/4/2020,三,中國客運碼頭,入境,0,0,0,0
11/4/2020,三,中國客運碼頭,出境,0,0,0,0
11/4/2020,三,港口管制,入境,0,0,0,0
11/4/2020,三,港口管制,出境,0,0,0,0
11/4/2020,三,啟德郵輪碼頭,入境,0,0,0,0
11/4/2020,三,啟德郵輪碼頭,出境,0,0,0,0
11/4/2020,三,港澳客輪碼頭,入境,0,0,0,0
11/4/2020,三,港澳客輪碼頭,出境,0,0,0,0
11/4/2020,三,屯門客運碼頭,入境,0,0,0,0
11/4/2020,三,屯門客運碼頭,出境,0,0,0,0
12/4/2020,三,機場,入境,544,4,24,572
12/4/2020,三,機場,出境,352,30,54,436
12/4/2020,三,高鐵西九龍,入境,0,0,0,0
12/4/2020,三,高鐵西九龍,出境,0,0,0,0
12/4/2020,三,紅磡,入境,0,0,0,0
12/4/2020,三,紅磡,出境,0,0,0,0
12/4/2020,三,羅湖,入境,0,0,0,0
12/4/2020,三,羅湖,出境,0,0,0,0
12/4/2020,三,落馬洲支線,入境,0,0,0,0
12/4/2020,三,落馬洲支線,出境,0,0,0,0
12/4/2020,三,港珠澳大橋,入境,49,4,1,54
12/4/2020,三,港珠澳大橋,出境,10,0,0,10
12/4/2020,三,落馬洲,入境,0,0,0,0
12/4/2020,三,落馬洲,出境,0,0,0,0
12/4/2020,三,文錦渡,入境,0,0,0,0
12/4/2020,三,文錦渡,出境,0,0,0,0
12/4/2020,三,沙頭角,入境,0,0,0,0
12/4/2020,三,沙頭角,出境,0,0,0,0
12/4/2020,三,深圳灣,入境,455,99,1,555
12/4/2020,三,深圳灣,出境,258,57,1,316
12/4/2020,三,中國客運碼頭,入境,0,0,0,0
12/4/2020,三,中國客運碼頭,出境,0,0,0,0
12/4/2020,三,港口管制,入境,0,0,0,0
12/4/2020,三,港口管制,出境,0,0,0,0
12/4/2020,三,啟德郵輪碼頭,入境,0,0,0,0
12/4/2020,三,啟德郵輪碼頭,出境,0,0,0,0
12/4/2020,三,港澳客輪碼頭,入境,0,0,0,0
12/4/2020,三,港澳客輪碼頭,出境,0,0,0,0
12/4/2020,三,屯門客運碼頭,入境,0,0,0,0
12/4/2020,三,屯門客運碼頭,出境,0,0,0,0
13/4/2020,三,機場,入境,395,1,18,414
13/4/2020,三,機場,出境,71,6,28,105
13/4/2020,三,高鐵西九龍,入境,0,0,0,0
13/4/2020,三,高鐵西九龍,出境,0,0,0,0
13/4/2020,三,紅磡,入境,0,0,0,0
13/4/2020,三,紅磡,出境,0,0,0,0
13/4/2020,三,羅湖,入境,0,0,0,0
13/4/2020,三,羅湖,出境,0,0,0,0
13/4/2020,三,落馬洲支線,入境,0,0,0,0
13/4/2020,三,落馬洲支線,出境,0,0,0,0
13/4/2020,三,港珠澳大橋,入境,51,3,0,54
13/4/2020,三,港珠澳大橋,出境,17,1,1,19
13/4/2020,三,落馬洲,入境,0,0,0,0
13/4/2020,三,落馬洲,出境,0,0,0,0
13/4/2020,三,文錦渡,入境,0,0,0,0
13/4/2020,三,文錦渡,出境,0,0,0,0
13/4/2020,三,沙頭角,入境,0,0,0,0
13/4/2020,三,沙頭角,出境,0,0,0,0
13/4/2020,三,深圳灣,入境,511,98,5,614
13/4/2020,三,深圳灣,出境,273,72,4,349
13/4/2020,三,中國客運碼頭,入境,0,0,0,0
13/4/2020,三,中國客運碼頭,出境,0,0,0,0
13/4/2020,三,港口管制,入境,0,0,0,0
13/4/2020,三,港口管制,出境,0,0,0,0
13/4/2020,三,啟德郵輪碼頭,入境,0,0,0,0
13/4/2020,三,啟德郵輪碼頭,出境,0,0,0,0
13/4/2020,三,港澳客輪碼頭,入境,0,0,0,0
13/4/2020,三,港澳客輪碼頭,出境,0,0,0,0
13/4/2020,三,屯門客運碼頭,入境,0,0,0,0
13/4/2020,三,屯門客運碼頭,出境,0,0,0,0
14/4/2020,三,機場,入境,430,7,10,447
14/4/2020,三,機場,出境,150,10,50,210
14/4/2020,三,高鐵西九龍,入境,0,0,0,0
14/4/2020,三,高鐵西九龍,出境,0,0,0,0
14/4/2020,三,紅磡,入境,0,0,0,0
14/4/2020,三,紅磡,出境,0,0,0,0
14/4/2020,三,羅湖,入境,0,0,0,0
14/4/2020,三,羅湖,出境,0,0,0,0
14/4/2020,三,落馬洲支線,入境,0,0,0,0
14/4/2020,三,落馬洲支線,出境,0,0,0,0
14/4/2020,三,港珠澳大橋,入境,36,4,1,41
14/4/2020,三,港珠澳大橋,出境,21,5,3,29
14/4/2020,三,落馬洲,入境,0,0,0,0
14/4/2020,三,落馬洲,出境,0,0,0,0
14/4/2020,三,文錦渡,入境,0,0,0,0
14/4/2020,三,文錦渡,出境,0,0,0,0
14/4/2020,三,沙頭角,入境,0,0,0,0
14/4/2020,三,沙頭角,出境,0,0,0,0
14/4/2020,三,深圳灣,入境,588,70,0,658
14/4/2020,三,深圳灣,出境,275,64,1,340
14/4/2020,三,中國客運碼頭,入境,0,0,0,0
14/4/2020,三,中國客運碼頭,出境,0,0,0,0
14/4/2020,三,港口管制,入境,0,0,0,0
14/4/2020,三,港口管制,出境,0,0,0,0
14/4/2020,三,啟德郵輪碼頭,入境,0,0,0,0
14/4/2020,三,啟德郵輪碼頭,出境,0,0,0,0
14/4/2020,三,港澳客輪碼頭,入境,0,0,0,0
14/4/2020,三,港澳客輪碼頭,出境,0,0,0,0
14/4/2020,三,屯門客運碼頭,入境,0,0,0,0
14/4/2020,三,屯門客運碼頭,出境,0,0,0,0
15/4/2020,三,機場,入境,481,2,16,499
15/4/2020,三,機場,出境,331,12,60,403
15/4/2020,三,高鐵西九龍,入境,0,0,0,0
15/4/2020,三,高鐵西九龍,出境,0,0,0,0
15/4/2020,三,紅磡,入境,0,0,0,0
15/4/2020,三,紅磡,出境,0,0,0,0
15/4/2020,三,羅湖,入境,0,0,0,0
15/4/2020,三,羅湖,出境,0,0,0,0
15/4/2020,三,落馬洲支線,入境,0,0,0,0
15/4/2020,三,落馬洲支線,出境,0,0,0,0
15/4/2020,三,港珠澳大橋,入境,33,4,1,38
15/4/2020,三,港珠澳大橋,出境,17,3,0,20
15/4/2020,三,落馬洲,入境,0,0,0,0
15/4/2020,三,落馬洲,出境,0,0,0,0
15/4/2020,三,文錦渡,入境,0,0,0,0
15/4/2020,三,文錦渡,出境,0,0,0,0
15/4/2020,三,沙頭角,入境,0,0,0,0
15/4/2020,三,沙頭角,出境,0,0,0,0
15/4/2020,三,深圳灣,入境,613,93,1,707
15/4/2020,三,深圳灣,出境,240,69,2,311
15/4/2020,三,中國客運碼頭,入境,0,0,0,0
15/4/2020,三,中國客運碼頭,出境,0,0,0,0
15/4/2020,三,港口管制,入境,0,0,0,0
15/4/2020,三,港口管制,出境,0,0,0,0
15/4/2020,三,啟德郵輪碼頭,入境,0,0,0,0
15/4/2020,三,啟德郵輪碼頭,出境,0,0,0,0
15/4/2020,三,港澳客輪碼頭,入境,0,0,0,0
15/4/2020,三,港澳客輪碼頭,出境,0,0,0,0
15/4/2020,三,屯門客運碼頭,入境,0,0,0,0
15/4/2020,三,屯門客運碼頭,出境,0,0,0,0
16/4/2020,三,機場,入境,397,1,19,417
16/4/2020,三,機場,出境,147,15,24,186
16/4/2020,三,高鐵西九龍,入境,0,0,0,0
16/4/2020,三,高鐵西九龍,出境,0,0,0,0
16/4/2020,三,紅磡,入境,0,0,0,0
16/4/2020,三,紅磡,出境,0,0,0,0
16/4/2020,三,羅湖,入境,0,0,0,0
16/4/2020,三,羅湖,出境,0,0,0,0
16/4/2020,三,落馬洲支線,入境,0,0,0,0
16/4/2020,三,落馬洲支線,出境,0,0,0,0
16/4/2020,三,港珠澳大橋,入境,26,2,0,28
16/4/2020,三,港珠澳大橋,出境,11,0,1,12
16/4/2020,三,落馬洲,入境,0,0,0,0
16/4/2020,三,落馬洲,出境,0,0,0,0
16/4/2020,三,文錦渡,入境,0,0,0,0
16/4/2020,三,文錦渡,出境,0,0,0,0
16/4/2020,三,沙頭角,入境,0,0,0,0
16/4/2020,三,沙頭角,出境,0,0,0,0
16/4/2020,三,深圳灣,入境,527,81,3,611
16/4/2020,三,深圳灣,出境,223,56,0,279
16/4/2020,三,中國客運碼頭,入境,0,0,0,0
16/4/2020,三,中國客運碼頭,出境,0,0,0,0
16/4/2020,三,港口管制,入境,0,0,0,0
16/4/2020,三,港口管制,出境,0,0,0,0
16/4/2020,三,啟德郵輪碼頭,入境,0,0,0,0
16/4/2020,三,啟德郵輪碼頭,出境,0,0,0,0
16/4/2020,三,港澳客輪碼頭,入境,0,0,0,0
16/4/2020,三,港澳客輪碼頭,出境,0,0,0,0
16/4/2020,三,屯門客運碼頭,入境,0,0,0,0
16/4/2020,三,屯門客運碼頭,出境,0,0,0,0
17/4/2020,三,機場,入境,820,6,20,846
17/4/2020,三,機場,出境,507,15,80,602
17/4/2020,三,高鐵西九龍,入境,0,0,0,0
17/4/2020,三,高鐵西九龍,出境,0,0,0,0
17/4/2020,三,紅磡,入境,0,0,0,0
17/4/2020,三,紅磡,出境,0,0,0,0
17/4/2020,三,羅湖,入境,0,0,0,0
17/4/2020,三,羅湖,出境,0,0,0,0
17/4/2020,三,落馬洲支線,入境,0,0,0,0
17/4/2020,三,落馬洲支線,出境,0,0,0,0
17/4/2020,三,港珠澳大橋,入境,24,4,2,30
17/4/2020,三,港珠澳大橋,出境,27,2,2,31
17/4/2020,三,落馬洲,入境,0,0,0,0
17/4/2020,三,落馬洲,出境,0,0,0,0
17/4/2020,三,文錦渡,入境,0,0,0,0
17/4/2020,三,文錦渡,出境,0,0,0,0
17/4/2020,三,沙頭角,入境,0,0,0,0
17/4/2020,三,沙頭角,出境,0,0,0,0
17/4/2020,三,深圳灣,入境,519,77,4,600
17/4/2020,三,深圳灣,出境,180,54,4,238
17/4/2020,三,中國客運碼頭,入境,0,0,0,0
17/4/2020,三,中國客運碼頭,出境,0,0,0,0
17/4/2020,三,港口管制,入境,0,0,0,0
17/4/2020,三,港口管制,出境,0,0,0,0
17/4/2020,三,啟德郵輪碼頭,入境,0,0,0,0
17/4/2020,三,啟德郵輪碼頭,出境,0,0,0,0
17/4/2020,三,港澳客輪碼頭,入境,0,0,0,0
17/4/2020,三,港澳客輪碼頭,出境,0,0,0,0
17/4/2020,三,屯門客運碼頭,入境,0,0,0,0
17/4/2020,三,屯門客運碼頭,出境,0,0,0,0
18/4/2020,三,機場,入境,373,9,14,396
18/4/2020,三,機場,出境,336,19,67,422
18/4/2020,三,高鐵西九龍,入境,0,0,0,0
18/4/2020,三,高鐵西九龍,出境,0,0,0,0
18/4/2020,三,紅磡,入境,0,0,0,0
18/4/2020,三,紅磡,出境,0,0,0,0
18/4/2020,三,羅湖,入境,0,0,0,0
18/4/2020,三,羅湖,出境,0,0,0,0
18/4/2020,三,落馬洲支線,入境,0,0,0,0
18/4/2020,三,落馬洲支線,出境,0,0,0,0
18/4/2020,三,港珠澳大橋,入境,33,8,1,42
18/4/2020,三,港珠澳大橋,出境,11,4,6,21
18/4/2020,三,落馬洲,入境,0,0,0,0
18/4/2020,三,落馬洲,出境,0,0,0,0
18/4/2020,三,文錦渡,入境,0,0,0,0
18/4/2020,三,文錦渡,出境,0,0,0,0
18/4/2020,三,沙頭角,入境,0,0,0,0
18/4/2020,三,沙頭角,出境,0,0,0,0
18/4/2020,三,深圳灣,入境,456,86,0,542
18/4/2020,三,深圳灣,出境,194,65,4,263
18/4/2020,三,中國客運碼頭,入境,0,0,0,0
18/4/2020,三,中國客運碼頭,出境,0,0,0,0
18/4/2020,三,港口管制,入境,0,0,0,0
18/4/2020,三,港口管制,出境,0,0,0,0
18/4/2020,三,啟德郵輪碼頭,入境,0,0,0,0
18/4/2020,三,啟德郵輪碼頭,出境,0,0,0,0
18/4/2020,三,港澳客輪碼頭,入境,0,0,0,0
18/4/2020,三,港澳客輪碼頭,出境,0,0,0,0
18/4/2020,三,屯門客運碼頭,入境,0,0,0,0
18/4/2020,三,屯門客運碼頭,出境,0,0,0,0
19/4/2020,三,機場,入境,452,2,13,467
19/4/2020,三,機場,出境,273,2,44,319
19/4/2020,三,高鐵西九龍,入境,0,0,0,0
19/4/2020,三,高鐵西九龍,出境,0,0,0,0
19/4/2020,三,紅磡,入境,0,0,0,0
19/4/2020,三,紅磡,出境,0,0,0,0
19/4/2020,三,羅湖,入境,0,0,0,0
19/4/2020,三,羅湖,出境,0,0,0,0
19/4/2020,三,落馬洲支線,入境,0,0,0,0
19/4/2020,三,落馬洲支線,出境,0,0,0,0
19/4/2020,三,港珠澳大橋,入境,21,1,0,22
19/4/2020,三,港珠澳大橋,出境,7,0,0,7
19/4/2020,三,落馬洲,入境,0,0,0,0
19/4/2020,三,落馬洲,出境,0,0,0,0
19/4/2020,三,文錦渡,入境,0,0,0,0
19/4/2020,三,文錦渡,出境,0,0,0,0
19/4/2020,三,沙頭角,入境,0,0,0,0
19/4/2020,三,沙頭角,出境,0,0,0,0
19/4/2020,三,深圳灣,入境,543,96,3,642
19/4/2020,三,深圳灣,出境,168,53,0,221
19/4/2020,三,中國客運碼頭,入境,0,0,0,0
19/4/2020,三,中國客運碼頭,出境,0,0,0,0
19/4/2020,三,港口管制,入境,0,0,0,0
19/4/2020,三,港口管制,出境,0,0,0,0
19/4/2020,三,啟德郵輪碼頭,入境,0,0,0,0
19/4/2020,三,啟德郵輪碼頭,出境,0,0,0,0
19/4/2020,三,港澳客輪碼頭,入境,0,0,0,0
19/4/2020,三,港澳客輪碼頭,出境,0,0,0,0
19/4/2020,三,屯門客運碼頭,入境,0,0,0,0
19/4/2020,三,屯門客運碼頭,出境,0,0,0,0
20/4/2020,三,機場,入境,460,6,20,486
20/4/2020,三,機場,出境,190,26,25,241
20/4/2020,三,高鐵西九龍,入境,0,0,0,0
20/4/2020,三,高鐵西九龍,出境,0,0,0,0
20/4/2020,三,紅磡,入境,0,0,0,0
20/4/2020,三,紅磡,出境,0,0,0,0
20/4/2020,三,羅湖,入境,0,0,0,0
20/4/2020,三,羅湖,出境,0,0,0,0
20/4/2020,三,落馬洲支線,入境,0,0,0,0
20/4/2020,三,落馬洲支線,出境,0,0,0,0
20/4/2020,三,港珠澳大橋,入境,40,0,1,41
20/4/2020,三,港珠澳大橋,出境,12,1,0,13
20/4/2020,三,落馬洲,入境,0,0,0,0
20/4/2020,三,落馬洲,出境,0,0,0,0
20/4/2020,三,文錦渡,入境,0,0,0,0
20/4/2020,三,文錦渡,出境,0,0,0,0
20/4/2020,三,沙頭角,入境,0,0,0,0
20/4/2020,三,沙頭角,出境,0,0,0,0
20/4/2020,三,深圳灣,入境,663,80,2,745
20/4/2020,三,深圳灣,出境,306,73,7,386
20/4/2020,三,中國客運碼頭,入境,0,0,0,0
20/4/2020,三,中國客運碼頭,出境,0,0,0,0
20/4/2020,三,港口管制,入境,0,0,0,0
20/4/2020,三,港口管制,出境,0,0,0,0
20/4/2020,三,啟德郵輪碼頭,入境,0,0,0,0
20/4/2020,三,啟德郵輪碼頭,出境,0,0,0,0
20/4/2020,三,港澳客輪碼頭,入境,0,0,0,0
20/4/2020,三,港澳客輪碼頭,出境,0,0,0,0
20/4/2020,三,屯門客運碼頭,入境,0,0,0,0
20/4/2020,三,屯門客運碼頭,出境,0,0,0,0
21/4/2020,三,機場,入境,324,3,22,349
21/4/2020,三,機場,出境,86,3,28,117
21/4/2020,三,高鐵西九龍,入境,0,0,0,0
21/4/2020,三,高鐵西九龍,出境,0,0,0,0
21/4/2020,三,紅磡,入境,0,0,0,0
21/4/2020,三,紅磡,出境,0,0,0,0
21/4/2020,三,羅湖,入境,0,0,0,0
21/4/2020,三,羅湖,出境,0,0,0,0
21/4/2020,三,落馬洲支線,入境,0,0,0,0
21/4/2020,三,落馬洲支線,出境,0,0,0,0
21/4/2020,三,港珠澳大橋,入境,24,4,0,28
21/4/2020,三,港珠澳大橋,出境,24,5,2,31
21/4/2020,三,落馬洲,入境,0,0,0,0
21/4/2020,三,落馬洲,出境,0,0,0,0
21/4/2020,三,文錦渡,入境,0,0,0,0
21/4/2020,三,文錦渡,出境,0,0,0,0
21/4/2020,三,沙頭角,入境,0,0,0,0
21/4/2020,三,沙頭角,出境,0,0,0,0
21/4/2020,三,深圳灣,入境,438,66,1,505
21/4/2020,三,深圳灣,出境,213,37,1,251
21/4/2020,三,中國客運碼頭,入境,0,0,0,0
21/4/2020,三,中國客運碼頭,出境,0,0,0,0
21/4/2020,三,港口管制,入境,0,0,0,0
21/4/2020,三,港口管制,出境,0,0,0,0
21/4/2020,三,啟德郵輪碼頭,入境,0,0,0,0
21/4/2020,三,啟德郵輪碼頭,出境,0,0,0,0
21/4/2020,三,港澳客輪碼頭,入境,0,0,0,0
21/4/2020,三,港澳客輪碼頭,出境,0,0,0,0
21/4/2020,三,屯門客運碼頭,入境,0,0,0,0
21/4/2020,三,屯門客運碼頭,出境,0,0,0,0
22/4/2020,三,機場,入境,561,2,29,592
22/4/2020,三,機場,出境,243,6,57,306
22/4/2020,三,高鐵西九龍,入境,0,0,0,0
22/4/2020,三,高鐵西九龍,出境,0,0,0,0
22/4/2020,三,紅磡,入境,0,0,0,0
22/4/2020,三,紅磡,出境,0,0,0,0
22/4/2020,三,羅湖,入境,0,0,0,0
22/4/2020,三,羅湖,出境,0,0,0,0
22/4/2020,三,落馬洲支線,入境,0,0,0,0
22/4/2020,三,落馬洲支線,出境,0,0,0,0
22/4/2020,三,港珠澳大橋,入境,47,3,1,51
22/4/2020,三,港珠澳大橋,出境,11,4,1,16
22/4/2020,三,落馬洲,入境,0,0,0,0
22/4/2020,三,落馬洲,出境,0,0,0,0
22/4/2020,三,文錦渡,入境,0,0,0,0
22/4/2020,三,文錦渡,出境,0,0,0,0
22/4/2020,三,沙頭角,入境,0,0,0,0
22/4/2020,三,沙頭角,出境,0,0,0,0
22/4/2020,三,深圳灣,入境,384,60,3,447
22/4/2020,三,深圳灣,出境,242,44,0,286
22/4/2020,三,中國客運碼頭,入境,0,0,0,0
22/4/2020,三,中國客運碼頭,出境,0,0,0,0
22/4/2020,三,港口管制,入境,0,0,0,0
22/4/2020,三,港口管制,出境,0,0,0,0
22/4/2020,三,啟德郵輪碼頭,入境,0,0,0,0
22/4/2020,三,啟德郵輪碼頭,出境,0,0,0,0
22/4/2020,三,港澳客輪碼頭,入境,0,0,0,0
22/4/2020,三,港澳客輪碼頭,出境,0,0,0,0
22/4/2020,三,屯門客運碼頭,入境,0,0,0,0
22/4/2020,三,屯門客運碼頭,出境,0,0,0,0
23/4/2020,三,機場,入境,241,2,19,262
23/4/2020,三,機場,出境,179,13,59,251
23/4/2020,三,高鐵西九龍,入境,0,0,0,0
23/4/2020,三,高鐵西九龍,出境,0,0,0,0
23/4/2020,三,紅磡,入境,0,0,0,0
23/4/2020,三,紅磡,出境,0,0,0,0
23/4/2020,三,羅湖,入境,0,0,0,0
23/4/2020,三,羅湖,出境,0,0,0,0
23/4/2020,三,落馬洲支線,入境,0,0,0,0
23/4/2020,三,落馬洲支線,出境,0,0,0,0
23/4/2020,三,港珠澳大橋,入境,24,1,1,26
23/4/2020,三,港珠澳大橋,出境,8,1,2,11
23/4/2020,三,落馬洲,入境,0,0,0,0
23/4/2020,三,落馬洲,出境,0,0,0,0
23/4/2020,三,文錦渡,入境,0,0,0,0
23/4/2020,三,文錦渡,出境,0,0,0,0
23/4/2020,三,沙頭角,入境,0,0,0,0
23/4/2020,三,沙頭角,出境,0,0,0,0
23/4/2020,三,深圳灣,入境,351,56,1,408
23/4/2020,三,深圳灣,出境,210,64,1,275
23/4/2020,三,中國客運碼頭,入境,0,0,0,0
23/4/2020,三,中國客運碼頭,出境,0,0,0,0
23/4/2020,三,港口管制,入境,0,0,0,0
23/4/2020,三,港口管制,出境,0,0,0,0
23/4/2020,三,啟德郵輪碼頭,入境,0,0,0,0
23/4/2020,三,啟德郵輪碼頭,出境,0,0,0,0
23/4/2020,三,港澳客輪碼頭,入境,0,0,0,0
23/4/2020,三,港澳客輪碼頭,出境,0,0,0,0
23/4/2020,三,屯門客運碼頭,入境,0,0,0,0
23/4/2020,三,屯門客運碼頭,出境,0,0,0,0
24/4/2020,三,機場,入境,817,0,26,843
24/4/2020,三,機場,出境,374,5,63,442
24/4/2020,三,高鐵西九龍,入境,0,0,0,0
24/4/2020,三,高鐵西九龍,出境,0,0,0,0
24/4/2020,三,紅磡,入境,0,0,0,0
24/4/2020,三,紅磡,出境,0,0,0,0
24/4/2020,三,羅湖,入境,0,0,0,0
24/4/2020,三,羅湖,出境,0,0,0,0
24/4/2020,三,落馬洲支線,入境,0,0,0,0
24/4/2020,三,落馬洲支線,出境,0,0,0,0
24/4/2020,三,港珠澳大橋,入境,36,2,0,38
24/4/2020,三,港珠澳大橋,出境,13,2,0,15
24/4/2020,三,落馬洲,入境,0,0,0,0
24/4/2020,三,落馬洲,出境,0,0,0,0
24/4/2020,三,文錦渡,入境,0,0,0,0
24/4/2020,三,文錦渡,出境,0,0,0,0
24/4/2020,三,沙頭角,入境,0,0,0,0
24/4/2020,三,沙頭角,出境,0,0,0,0
24/4/2020,三,深圳灣,入境,397,38,0,435
24/4/2020,三,深圳灣,出境,214,36,2,252
24/4/2020,三,中國客運碼頭,入境,0,0,0,0
24/4/2020,三,中國客運碼頭,出境,0,0,0,0
24/4/2020,三,港口管制,入境,0,0,0,0
24/4/2020,三,港口管制,出境,0,0,0,0
24/4/2020,三,啟德郵輪碼頭,入境,0,0,0,0
24/4/2020,三,啟德郵輪碼頭,出境,0,0,0,0
24/4/2020,三,港澳客輪碼頭,入境,0,0,0,0
24/4/2020,三,港澳客輪碼頭,出境,0,0,0,0
24/4/2020,三,屯門客運碼頭,入境,0,0,0,0
24/4/2020,三,屯門客運碼頭,出境,0,0,0,0
25/4/2020,三,機場,入境,378,7,20,405
25/4/2020,三,機場,出境,241,13,41,295
25/4/2020,三,高鐵西九龍,入境,0,0,0,0
25/4/2020,三,高鐵西九龍,出境,0,0,0,0
25/4/2020,三,紅磡,入境,0,0,0,0
25/4/2020,三,紅磡,出境,0,0,0,0
25/4/2020,三,羅湖,入境,0,0,0,0
25/4/2020,三,羅湖,出境,0,0,0,0
25/4/2020,三,落馬洲支線,入境,0,0,0,0
25/4/2020,三,落馬洲支線,出境,0,0,0,0
25/4/2020,三,港珠澳大橋,入境,26,1,0,27
25/4/2020,三,港珠澳大橋,出境,19,0,0,19
25/4/2020,三,落馬洲,入境,0,0,0,0
25/4/2020,三,落馬洲,出境,0,0,0,0
25/4/2020,三,文錦渡,入境,0,0,0,0
25/4/2020,三,文錦渡,出境,0,0,0,0
25/4/2020,三,沙頭角,入境,0,0,0,0
25/4/2020,三,沙頭角,出境,0,0,0,0
25/4/2020,三,深圳灣,入境,429,67,4,500
25/4/2020,三,深圳灣,出境,208,37,0,245
25/4/2020,三,中國客運碼頭,入境,0,0,0,0
25/4/2020,三,中國客運碼頭,出境,0,0,0,0
25/4/2020,三,港口管制,入境,0,0,0,0
25/4/2020,三,港口管制,出境,0,0,0,0
25/4/2020,三,啟德郵輪碼頭,入境,0,0,0,0
25/4/2020,三,啟德郵輪碼頭,出境,0,0,0,0
25/4/2020,三,港澳客輪碼頭,入境,0,0,0,0
25/4/2020,三,港澳客輪碼頭,出境,0,0,0,0
25/4/2020,三,屯門客運碼頭,入境,0,0,0,0
25/4/2020,三,屯門客運碼頭,出境,0,0,0,0
26/4/2020,三,機場,入境,421,1,20,442
26/4/2020,三,機場,出境,333,18,35,386
26/4/2020,三,高鐵西九龍,入境,0,0,0,0
26/4/2020,三,高鐵西九龍,出境,0,0,0,0
26/4/2020,三,紅磡,入境,0,0,0,0
26/4/2020,三,紅磡,出境,0,0,0,0
26/4/2020,三,羅湖,入境,0,0,0,0
26/4/2020,三,羅湖,出境,0,0,0,0
26/4/2020,三,落馬洲支線,入境,0,0,0,0
26/4/2020,三,落馬洲支線,出境,0,0,0,0
26/4/2020,三,港珠澳大橋,入境,21,1,0,22
26/4/2020,三,港珠澳大橋,出境,8,1,0,9
26/4/2020,三,落馬洲,入境,0,0,0,0
26/4/2020,三,落馬洲,出境,0,0,0,0
26/4/2020,三,文錦渡,入境,0,0,0,0
26/4/2020,三,文錦渡,出境,0,0,0,0
26/4/2020,三,沙頭角,入境,0,0,0,0
26/4/2020,三,沙頭角,出境,0,0,0,0
26/4/2020,三,深圳灣,入境,407,80,4,491
26/4/2020,三,深圳灣,出境,184,59,2,245
26/4/2020,三,中國客運碼頭,入境,0,0,0,0
26/4/2020,三,中國客運碼頭,出境,0,0,0,0
26/4/2020,三,港口管制,入境,0,0,0,0
26/4/2020,三,港口管制,出境,0,0,0,0
26/4/2020,三,啟德郵輪碼頭,入境,0,0,0,0
26/4/2020,三,啟德郵輪碼頭,出境,0,0,0,0
26/4/2020,三,港澳客輪碼頭,入境,0,0,0,0
26/4/2020,三,港澳客輪碼頭,出境,0,0,0,0
26/4/2020,三,屯門客運碼頭,入境,0,0,0,0
26/4/2020,三,屯門客運碼頭,出境,0,0,0,0
27/4/2020,三,機場,入境,411,2,10,423
27/4/2020,三,機場,出境,125,1,22,148
27/4/2020,三,高鐵西九龍,入境,0,0,0,0
27/4/2020,三,高鐵西九龍,出境,0,0,0,0
27/4/2020,三,紅磡,入境,0,0,0,0
27/4/2020,三,紅磡,出境,0,0,0,0
27/4/2020,三,羅湖,入境,0,0,0,0
27/4/2020,三,羅湖,出境,0,0,0,0
27/4/2020,三,落馬洲支線,入境,0,0,0,0
27/4/2020,三,落馬洲支線,出境,0,0,0,0
27/4/2020,三,港珠澳大橋,入境,33,2,1,36
27/4/2020,三,港珠澳大橋,出境,36,1,3,40
27/4/2020,三,落馬洲,入境,0,0,0,0
27/4/2020,三,落馬洲,出境,0,0,0,0
27/4/2020,三,文錦渡,入境,0,0,0,0
27/4/2020,三,文錦渡,出境,0,0,0,0
27/4/2020,三,沙頭角,入境,0,0,0,0
27/4/2020,三,沙頭角,出境,0,0,0,0
27/4/2020,三,深圳灣,入境,454,70,1,525
27/4/2020,三,深圳灣,出境,577,146,7,730
27/4/2020,三,中國客運碼頭,入境,0,0,0,0
27/4/2020,三,中國客運碼頭,出境,0,0,0,0
27/4/2020,三,港口管制,入境,0,0,0,0
27/4/2020,三,港口管制,出境,0,0,0,0
27/4/2020,三,啟德郵輪碼頭,入境,0,0,0,0
27/4/2020,三,啟德郵輪碼頭,出境,0,0,0,0
27/4/2020,三,港澳客輪碼頭,入境,0,0,0,0
27/4/2020,三,港澳客輪碼頭,出境,0,0,0,0
27/4/2020,三,屯門客運碼頭,入境,0,0,0,0
27/4/2020,三,屯門客運碼頭,出境,0,0,0,0
28/4/2020,三,機場,入境,464,0,64,528
28/4/2020,三,機場,出境,160,1,50,211
28/4/2020,三,高鐵西九龍,入境,0,0,0,0
28/4/2020,三,高鐵西九龍,出境,0,0,0,0
28/4/2020,三,紅磡,入境,0,0,0,0
28/4/2020,三,紅磡,出境,0,0,0,0
28/4/2020,三,羅湖,入境,0,0,0,0
28/4/2020,三,羅湖,出境,0,0,0,0
28/4/2020,三,落馬洲支線,入境,0,0,0,0
28/4/2020,三,落馬洲支線,出境,0,0,0,0
28/4/2020,三,港珠澳大橋,入境,22,2,1,25
28/4/2020,三,港珠澳大橋,出境,19,1,3,23
28/4/2020,三,落馬洲,入境,0,0,0,0
28/4/2020,三,落馬洲,出境,0,0,0,0
28/4/2020,三,文錦渡,入境,0,0,0,0
28/4/2020,三,文錦渡,出境,0,0,0,0
28/4/2020,三,沙頭角,入境,0,0,0,0
28/4/2020,三,沙頭角,出境,0,0,0,0
28/4/2020,三,深圳灣,入境,341,49,1,391
28/4/2020,三,深圳灣,出境,176,25,3,204
28/4/2020,三,中國客運碼頭,入境,0,0,0,0
28/4/2020,三,中國客運碼頭,出境,0,0,0,0
28/4/2020,三,港口管制,入境,0,0,0,0
28/4/2020,三,港口管制,出境,0,0,0,0
28/4/2020,三,啟德郵輪碼頭,入境,0,0,0,0
28/4/2020,三,啟德郵輪碼頭,出境,0,0,0,0
28/4/2020,三,港澳客輪碼頭,入境,0,0,0,0
28/4/2020,三,港澳客輪碼頭,出境,0,0,0,0
28/4/2020,三,屯門客運碼頭,入境,0,0,0,0
28/4/2020,三,屯門客運碼頭,出境,0,0,0,0
29/4/2020,五+六,機場,入境,814,4,15,833
29/4/2020,五+六,機場,出境,341,6,44,391
29/4/2020,五+六,高鐵西九龍,入境,0,0,0,0
29/4/2020,五+六,高鐵西九龍,出境,0,0,0,0
29/4/2020,五+六,紅磡,入境,0,0,0,0
29/4/2020,五+六,紅磡,出境,0,0,0,0
29/4/2020,五+六,羅湖,入境,0,0,0,0
29/4/2020,五+六,羅湖,出境,0,0,0,0
29/4/2020,五+六,落馬洲支線,入境,0,0,0,0
29/4/2020,五+六,落馬洲支線,出境,0,0,0,0
29/4/2020,五+六,港珠澳大橋,入境,24,2,0,26
29/4/2020,五+六,港珠澳大橋,出境,18,1,1,20
29/4/2020,五+六,落馬洲,入境,0,0,0,0
29/4/2020,五+六,落馬洲,出境,0,0,0,0
29/4/2020,五+六,文錦渡,入境,0,0,0,0
29/4/2020,五+六,文錦渡,出境,0,0,0,0
29/4/2020,五+六,沙頭角,入境,0,0,0,0
29/4/2020,五+六,沙頭角,出境,0,0,0,0
29/4/2020,五+六,深圳灣,入境,455,70,2,527
29/4/2020,五+六,深圳灣,出境,242,23,5,270
29/4/2020,五+六,中國客運碼頭,入境,0,0,0,0
29/4/2020,五+六,中國客運碼頭,出境,0,0,0,0
29/4/2020,五+六,港口管制,入境,0,0,0,0
29/4/2020,五+六,港口管制,出境,0,0,0,0
29/4/2020,五+六,啟德郵輪碼頭,入境,0,0,0,0
29/4/2020,五+六,啟德郵輪碼頭,出境,0,0,0,0
29/4/2020,五+六,港澳客輪碼頭,入境,0,0,0,0
29/4/2020,五+六,港澳客輪碼頭,出境,0,0,0,0
29/4/2020,五+六,屯門客運碼頭,入境,0,0,0,0
29/4/2020,五+六,屯門客運碼頭,出境,0,0,0,0
30/4/2020,五+六,機場,入境,747,5,48,800
30/4/2020,五+六,機場,出境,254,17,31,302
30/4/2020,五+六,高鐵西九龍,入境,0,0,0,0
30/4/2020,五+六,高鐵西九龍,出境,0,0,0,0
30/4/2020,五+六,紅磡,入境,0,0,0,0
30/4/2020,五+六,紅磡,出境,0,0,0,0
30/4/2020,五+六,羅湖,入境,0,0,0,0
30/4/2020,五+六,羅湖,出境,0,0,0,0
30/4/2020,五+六,落馬洲支線,入境,0,0,0,0
30/4/2020,五+六,落馬洲支線,出境,0,0,0,0
30/4/2020,五+六,港珠澳大橋,入境,37,6,2,45
30/4/2020,五+六,港珠澳大橋,出境,31,2,3,36
30/4/2020,五+六,落馬洲,入境,0,0,0,0
30/4/2020,五+六,落馬洲,出境,0,0,0,0
30/4/2020,五+六,文錦渡,入境,0,0,0,0
30/4/2020,五+六,文錦渡,出境,0,0,0,0
30/4/2020,五+六,沙頭角,入境,0,0,0,0
30/4/2020,五+六,沙頭角,出境,0,0,0,0
30/4/2020,五+六,深圳灣,入境,827,114,2,943
30/4/2020,五+六,深圳灣,出境,348,70,4,422
30/4/2020,五+六,中國客運碼頭,入境,0,0,0,0
30/4/2020,五+六,中國客運碼頭,出境,0,0,0,0
30/4/2020,五+六,港口管制,入境,0,0,0,0
30/4/2020,五+六,港口管制,出境,0,0,0,0
30/4/2020,五+六,啟德郵輪碼頭,入境,0,0,0,0
30/4/2020,五+六,啟德郵輪碼頭,出境,0,0,0,0
30/4/2020,五+六,港澳客輪碼頭,入境,0,0,0,0
30/4/2020,五+六,港澳客輪碼頭,出境,0,0,0,0
30/4/2020,五+六,屯門客運碼頭,入境,0,0,0,0
30/4/2020,五+六,屯門客運碼頭,出境,0,0,0,0
1/5/2020,五+六,機場,入境,837,4,24,865
1/5/2020,五+六,機場,出境,533,6,98,637
1/5/2020,五+六,高鐵西九龍,入境,0,0,0,0
1/5/2020,五+六,高鐵西九龍,出境,0,0,0,0
1/5/2020,五+六,紅磡,入境,0,0,0,0
1/5/2020,五+六,紅磡,出境,0,0,0,0
1/5/2020,五+六,羅湖,入境,0,0,0,0
1/5/2020,五+六,羅湖,出境,0,0,0,0
1/5/2020,五+六,落馬洲支線,入境,0,0,0,0
1/5/2020,五+六,落馬洲支線,出境,0,0,0,0
1/5/2020,五+六,港珠澳大橋,入境,35,5,1,41
1/5/2020,五+六,港珠澳大橋,出境,17,1,1,19
1/5/2020,五+六,落馬洲,入境,0,0,0,0
1/5/2020,五+六,落馬洲,出境,0,0,0,0
1/5/2020,五+六,文錦渡,入境,0,0,0,0
1/5/2020,五+六,文錦渡,出境,0,0,0,0
1/5/2020,五+六,沙頭角,入境,0,0,0,0
1/5/2020,五+六,沙頭角,出境,0,0,0,0
1/5/2020,五+六,深圳灣,入境,507,110,5,622
1/5/2020,五+六,深圳灣,出境,265,56,1,322
1/5/2020,五+六,中國客運碼頭,入境,0,0,0,0
1/5/2020,五+六,中國客運碼頭,出境,0,0,0,0
1/5/2020,五+六,港口管制,入境,0,0,0,0
1/5/2020,五+六,港口管制,出境,0,0,0,0
1/5/2020,五+六,啟德郵輪碼頭,入境,0,0,0,0
1/5/2020,五+六,啟德郵輪碼頭,出境,0,0,0,0
1/5/2020,五+六,港澳客輪碼頭,入境,0,0,0,0
1/5/2020,五+六,港澳客輪碼頭,出境,0,0,0,0
1/5/2020,五+六,屯門客運碼頭,入境,0,0,0,0
1/5/2020,五+六,屯門客運碼頭,出境,0,0,0,0
2/5/2020,五+六,機場,入境,452,6,39,497
2/5/2020,五+六,機場,出境,352,4,72,428
2/5/2020,五+六,高鐵西九龍,入境,0,0,0,0
2/5/2020,五+六,高鐵西九龍,出境,0,0,0,0
2/5/2020,五+六,紅磡,入境,0,0,0,0
2/5/2020,五+六,紅磡,出境,0,0,0,0
2/5/2020,五+六,羅湖,入境,0,0,0,0
2/5/2020,五+六,羅湖,出境,0,0,0,0
2/5/2020,五+六,落馬洲支線,入境,0,0,0,0
2/5/2020,五+六,落馬洲支線,出境,0,0,0,0
2/5/2020,五+六,港珠澳大橋,入境,34,5,0,39
2/5/2020,五+六,港珠澳大橋,出境,24,0,0,24
2/5/2020,五+六,落馬洲,入境,0,0,0,0
2/5/2020,五+六,落馬洲,出境,0,0,0,0
2/5/2020,五+六,文錦渡,入境,0,0,0,0
2/5/2020,五+六,文錦渡,出境,0,0,0,0
2/5/2020,五+六,沙頭角,入境,0,0,0,0
2/5/2020,五+六,沙頭角,出境,0,0,0,0
2/5/2020,五+六,深圳灣,入境,534,89,0,623
2/5/2020,五+六,深圳灣,出境,220,27,3,250
2/5/2020,五+六,中國客運碼頭,入境,0,0,0,0
2/5/2020,五+六,中國客運碼頭,出境,0,0,0,0
2/5/2020,五+六,港口管制,入境,0,0,0,0
2/5/2020,五+六,港口管制,出境,0,0,0,0
2/5/2020,五+六,啟德郵輪碼頭,入境,0,0,0,0
2/5/2020,五+六,啟德郵輪碼頭,出境,0,0,0,0
2/5/2020,五+六,港澳客輪碼頭,入境,0,0,0,0
2/5/2020,五+六,港澳客輪碼頭,出境,0,0,0,0
2/5/2020,五+六,屯門客運碼頭,入境,0,0,0,0
2/5/2020,五+六,屯門客運碼頭,出境,0,0,0,0
3/5/2020,五+六,機場,入境,713,1,26,740
3/5/2020,五+六,機場,出境,212,6,44,262
3/5/2020,五+六,高鐵西九龍,入境,0,0,0,0
3/5/2020,五+六,高鐵西九龍,出境,0,0,0,0
3/5/2020,五+六,紅磡,入境,0,0,0,0
3/5/2020,五+六,紅磡,出境,0,0,0,0
3/5/2020,五+六,羅湖,入境,0,0,0,0
3/5/2020,五+六,羅湖,出境,0,0,0,0
3/5/2020,五+六,落馬洲支線,入境,0,0,0,0
3/5/2020,五+六,落馬洲支線,出境,0,0,0,0
3/5/2020,五+六,港珠澳大橋,入境,38,1,7,46
3/5/2020,五+六,港珠澳大橋,出境,10,2,4,16
3/5/2020,五+六,落馬洲,入境,0,0,0,0
3/5/2020,五+六,落馬洲,出境,0,0,0,0
3/5/2020,五+六,文錦渡,入境,0,0,0,0
3/5/2020,五+六,文錦渡,出境,0,0,0,0
3/5/2020,五+六,沙頭角,入境,0,0,0,0
3/5/2020,五+六,沙頭角,出境,0,0,0,0
3/5/2020,五+六,深圳灣,入境,719,140,2,861
3/5/2020,五+六,深圳灣,出境,211,40,2,253
3/5/2020,五+六,中國客運碼頭,入境,0,0,0,0
3/5/2020,五+六,中國客運碼頭,出境,0,0,0,0
3/5/2020,五+六,港口管制,入境,0,0,0,0
3/5/2020,五+六,港口管制,出境,0,0,0,0
3/5/2020,五+六,啟德郵輪碼頭,入境,0,0,0,0
3/5/2020,五+六,啟德郵輪碼頭,出境,0,0,0,0
3/5/2020,五+六,港澳客輪碼頭,入境,0,0,0,0
3/5/2020,五+六,港澳客輪碼頭,出境,0,0,0,0
3/5/2020,五+六,屯門客運碼頭,入境,0,0,0,0
3/5/2020,五+六,屯門客運碼頭,出境,0,0,0,0
4/5/2020,五+六,機場,入境,770,10,19,799
4/5/2020,五+六,機場,出境,251,4,161,416
4/5/2020,五+六,高鐵西九龍,入境,0,0,0,0
4/5/2020,五+六,高鐵西九龍,出境,0,0,0,0
4/5/2020,五+六,紅磡,入境,0,0,0,0
4/5/2020,五+六,紅磡,出境,0,0,0,0
4/5/2020,五+六,羅湖,入境,0,0,0,0
4/5/2020,五+六,羅湖,出境,0,0,0,0
4/5/2020,五+六,落馬洲支線,入境,0,0,0,0
4/5/2020,五+六,落馬洲支線,出境,0,0,0,0
4/5/2020,五+六,港珠澳大橋,入境,50,5,11,66
4/5/2020,五+六,港珠澳大橋,出境,19,1,0,20
4/5/2020,五+六,落馬洲,入境,0,0,0,0
4/5/2020,五+六,落馬洲,出境,0,0,0,0
4/5/2020,五+六,文錦渡,入境,0,0,0,0
4/5/2020,五+六,文錦渡,出境,0,0,0,0
4/5/2020,五+六,沙頭角,入境,0,0,0,0
4/5/2020,五+六,沙頭角,出境,0,0,0,0
4/5/2020,五+六,深圳灣,入境,629,79,4,712
4/5/2020,五+六,深圳灣,出境,288,33,6,327
4/5/2020,五+六,中國客運碼頭,入境,0,0,0,0
4/5/2020,五+六,中國客運碼頭,出境,0,0,0,0
4/5/2020,五+六,港口管制,入境,0,0,0,0
4/5/2020,五+六,港口管制,出境,0,0,0,0
4/5/2020,五+六,啟德郵輪碼頭,入境,0,0,0,0
4/5/2020,五+六,啟德郵輪碼頭,出境,0,0,0,0
4/5/2020,五+六,港澳客輪碼頭,入境,0,0,0,0
4/5/2020,五+六,港澳客輪碼頭,出境,0,0,0,0
4/5/2020,五+六,屯門客運碼頭,入境,0,0,0,0
4/5/2020,五+六,屯門客運碼頭,出境,0,0,0,0
5/5/2020,五+六,機場,入境,372,3,11,386
5/5/2020,五+六,機場,出境,138,2,24,164
5/5/2020,五+六,高鐵西九龍,入境,0,0,0,0
5/5/2020,五+六,高鐵西九龍,出境,0,0,0,0
5/5/2020,五+六,紅磡,入境,0,0,0,0
5/5/2020,五+六,紅磡,出境,0,0,0,0
5/5/2020,五+六,羅湖,入境,0,0,0,0
5/5/2020,五+六,羅湖,出境,0,0,0,0
5/5/2020,五+六,落馬洲支線,入境,0,0,0,0
5/5/2020,五+六,落馬洲支線,出境,0,0,0,0
5/5/2020,五+六,港珠澳大橋,入境,49,6,2,57
5/5/2020,五+六,港珠澳大橋,出境,29,0,2,31
5/5/2020,五+六,落馬洲,入境,0,0,0,0
5/5/2020,五+六,落馬洲,出境,0,0,0,0
5/5/2020,五+六,文錦渡,入境,0,0,0,0
5/5/2020,五+六,文錦渡,出境,0,0,0,0
5/5/2020,五+六,沙頭角,入境,0,0,0,0
5/5/2020,五+六,沙頭角,出境,0,0,0,0
5/5/2020,五+六,深圳灣,入境,587,75,1,663
5/5/2020,五+六,深圳灣,出境,257,36,12,305
5/5/2020,五+六,中國客運碼頭,入境,0,0,0,0
5/5/2020,五+六,中國客運碼頭,出境,0,0,0,0
5/5/2020,五+六,港口管制,入境,0,0,0,0
5/5/2020,五+六,港口管制,出境,0,0,0,0
5/5/2020,五+六,啟德郵輪碼頭,入境,0,0,0,0
5/5/2020,五+六,啟德郵輪碼頭,出境,0,0,0,0
5/5/2020,五+六,港澳客輪碼頭,入境,0,0,0,0
5/5/2020,五+六,港澳客輪碼頭,出境,0,0,0,0
5/5/2020,五+六,屯門客運碼頭,入境,0,0,0,0
5/5/2020,五+六,屯門客運碼頭,出境,0,0,0,0
6/5/2020,五+六,機場,入境,496,4,13,513
6/5/2020,五+六,機場,出境,313,9,30,352
6/5/2020,五+六,高鐵西九龍,入境,0,0,0,0
6/5/2020,五+六,高鐵西九龍,出境,0,0,0,0
6/5/2020,五+六,紅磡,入境,0,0,0,0
6/5/2020,五+六,紅磡,出境,0,0,0,0
6/5/2020,五+六,羅湖,入境,0,0,0,0
6/5/2020,五+六,羅湖,出境,0,0,0,0
6/5/2020,五+六,落馬洲支線,入境,0,0,0,0
6/5/2020,五+六,落馬洲支線,出境,0,0,0,0
6/5/2020,五+六,港珠澳大橋,入境,53,4,6,63
6/5/2020,五+六,港珠澳大橋,出境,13,2,3,18
6/5/2020,五+六,落馬洲,入境,0,0,0,0
6/5/2020,五+六,落馬洲,出境,0,0,0,0
6/5/2020,五+六,文錦渡,入境,0,0,0,0
6/5/2020,五+六,文錦渡,出境,0,0,0,0
6/5/2020,五+六,沙頭角,入境,0,0,0,0
6/5/2020,五+六,沙頭角,出境,0,0,0,0
6/5/2020,五+六,深圳灣,入境,754,79,1,834
6/5/2020,五+六,深圳灣,出境,287,43,7,337
6/5/2020,五+六,中國客運碼頭,入境,0,0,0,0
6/5/2020,五+六,中國客運碼頭,出境,0,0,0,0
6/5/2020,五+六,港口管制,入境,0,0,0,0
6/5/2020,五+六,港口管制,出境,0,0,0,0
6/5/2020,五+六,啟德郵輪碼頭,入境,0,0,0,0
6/5/2020,五+六,啟德郵輪碼頭,出境,0,0,0,0
6/5/2020,五+六,港澳客輪碼頭,入境,0,0,0,0
6/5/2020,五+六,港澳客輪碼頭,出境,0,0,0,0
6/5/2020,五+六,屯門客運碼頭,入境,0,0,0,0
6/5/2020,五+六,屯門客運碼頭,出境,0,0,0,0
7/5/2020,五+六,機場,入境,301,5,5,311
7/5/2020,五+六,機場,出境,143,3,8,154
7/5/2020,五+六,高鐵西九龍,入境,0,0,0,0
7/5/2020,五+六,高鐵西九龍,出境,0,0,0,0
7/5/2020,五+六,紅磡,入境,0,0,0,0
7/5/2020,五+六,紅磡,出境,0,0,0,0
7/5/2020,五+六,羅湖,入境,0,0,0,0
7/5/2020,五+六,羅湖,出境,0,0,0,0
7/5/2020,五+六,落馬洲支線,入境,0,0,0,0
7/5/2020,五+六,落馬洲支線,出境,0,0,0,0
7/5/2020,五+六,港珠澳大橋,入境,52,0,2,54
7/5/2020,五+六,港珠澳大橋,出境,21,3,0,24
7/5/2020,五+六,落馬洲,入境,0,0,0,0
7/5/2020,五+六,落馬洲,出境,0,0,0,0
7/5/2020,五+六,文錦渡,入境,0,0,0,0
7/5/2020,五+六,文錦渡,出境,0,0,0,0
7/5/2020,五+六,沙頭角,入境,0,0,0,0
7/5/2020,五+六,沙頭角,出境,0,0,0,0
7/5/2020,五+六,深圳灣,入境,761,103,2,866
7/5/2020,五+六,深圳灣,出境,298,69,0,367
7/5/2020,五+六,中國客運碼頭,入境,0,0,0,0
7/5/2020,五+六,中國客運碼頭,出境,0,0,0,0
7/5/2020,五+六,港口管制,入境,0,0,0,0
7/5/2020,五+六,港口管制,出境,0,0,0,0
7/5/2020,五+六,啟德郵輪碼頭,入境,0,0,0,0
7/5/2020,五+六,啟德郵輪碼頭,出境,0,0,0,0
7/5/2020,五+六,港澳客輪碼頭,入境,0,0,0,0
7/5/2020,五+六,港澳客輪碼頭,出境,0,0,0,0
7/5/2020,五+六,屯門客運碼頭,入境,0,0,0,0
7/5/2020,五+六,屯門客運碼頭,出境,0,0,0,0
8/5/2020,五+六,機場,入境,1249,13,35,1297
8/5/2020,五+六,機場,出境,371,9,49,429
8/5/2020,五+六,高鐵西九龍,入境,0,0,0,0
8/5/2020,五+六,高鐵西九龍,出境,0,0,0,0
8/5/2020,五+六,紅磡,入境,0,0,0,0
8/5/2020,五+六,紅磡,出境,0,0,0,0
8/5/2020,五+六,羅湖,入境,0,0,0,0
8/5/2020,五+六,羅湖,出境,0,0,0,0
8/5/2020,五+六,落馬洲支線,入境,0,0,0,0
8/5/2020,五+六,落馬洲支線,出境,0,0,0,0
8/5/2020,五+六,港珠澳大橋,入境,153,7,9,169
8/5/2020,五+六,港珠澳大橋,出境,46,1,6,53
8/5/2020,五+六,落馬洲,入境,0,0,0,0
8/5/2020,五+六,落馬洲,出境,0,0,0,0
8/5/2020,五+六,文錦渡,入境,0,0,0,0
8/5/2020,五+六,文錦渡,出境,0,0,0,0
8/5/2020,五+六,沙頭角,入境,0,0,0,0
8/5/2020,五+六,沙頭角,出境,0,0,0,0
8/5/2020,五+六,深圳灣,入境,1045,137,4,1186
8/5/2020,五+六,深圳灣,出境,348,67,2,417
8/5/2020,五+六,中國客運碼頭,入境,0,0,0,0
8/5/2020,五+六,中國客運碼頭,出境,0,0,0,0
8/5/2020,五+六,港口管制,入境,0,0,0,0
8/5/2020,五+六,港口管制,出境,0,0,0,0
8/5/2020,五+六,啟德郵輪碼頭,入境,0,0,0,0
8/5/2020,五+六,啟德郵輪碼頭,出境,0,0,0,0
8/5/2020,五+六,港澳客輪碼頭,入境,0,0,0,0
8/5/2020,五+六,港澳客輪碼頭,出境,0,0,0,0
8/5/2020,五+六,屯門客運碼頭,入境,0,0,0,0
8/5/2020,五+六,屯門客運碼頭,出境,0,0,0,0
9/5/2020,五+六,機場,入境,560,6,63,629
9/5/2020,五+六,機場,出境,260,14,28,302
9/5/2020,五+六,高鐵西九龍,入境,0,0,0,0
9/5/2020,五+六,高鐵西九龍,出境,0,0,0,0
9/5/2020,五+六,紅磡,入境,0,0,0,0
9/5/2020,五+六,紅磡,出境,0,0,0,0
9/5/2020,五+六,羅湖,入境,0,0,0,0
9/5/2020,五+六,羅湖,出境,0,0,0,0
9/5/2020,五+六,落馬洲支線,入境,0,0,0,0
9/5/2020,五+六,落馬洲支線,出境,0,0,0,0
9/5/2020,五+六,港珠澳大橋,入境,144,7,4,155
9/5/2020,五+六,港珠澳大橋,出境,43,5,1,49
9/5/2020,五+六,落馬洲,入境,0,0,0,0
9/5/2020,五+六,落馬洲,出境,0,0,0,0
9/5/2020,五+六,文錦渡,入境,0,0,0,0
9/5/2020,五+六,文錦渡,出境,0,0,0,0
9/5/2020,五+六,沙頭角,入境,0,0,0,0
9/5/2020,五+六,沙頭角,出境,0,0,0,0
9/5/2020,五+六,深圳灣,入境,1056,156,5,1217
9/5/2020,五+六,深圳灣,出境,237,38,3,278
9/5/2020,五+六,中國客運碼頭,入境,0,0,0,0
9/5/2020,五+六,中國客運碼頭,出境,0,0,0,0
9/5/2020,五+六,港口管制,入境,0,0,0,0
9/5/2020,五+六,港口管制,出境,0,0,0,0
9/5/2020,五+六,啟德郵輪碼頭,入境,0,0,0,0
9/5/2020,五+六,啟德郵輪碼頭,出境,0,0,0,0
9/5/2020,五+六,港澳客輪碼頭,入境,0,0,0,0
9/5/2020,五+六,港澳客輪碼頭,出境,0,0,0,0
9/5/2020,五+六,屯門客運碼頭,入境,0,0,0,0
9/5/2020,五+六,屯門客運碼頭,出境,0,0,0,0
10/5/2020,五+六,機場,入境,923,7,41,971
10/5/2020,五+六,機場,出境,254,7,42,303
10/5/2020,五+六,高鐵西九龍,入境,0,0,0,0
10/5/2020,五+六,高鐵西九龍,出境,0,0,0,0
10/5/2020,五+六,紅磡,入境,0,0,0,0
10/5/2020,五+六,紅磡,出境,0,0,0,0
10/5/2020,五+六,羅湖,入境,0,0,0,0
10/5/2020,五+六,羅湖,出境,0,0,0,0
10/5/2020,五+六,落馬洲支線,入境,0,0,0,0
10/5/2020,五+六,落馬洲支線,出境,0,0,0,0
10/5/2020,五+六,港珠澳大橋,入境,126,6,5,137
10/5/2020,五+六,港珠澳大橋,出境,33,1,3,37
10/5/2020,五+六,落馬洲,入境,0,0,0,0
10/5/2020,五+六,落馬洲,出境,0,0,0,0
10/5/2020,五+六,文錦渡,入境,0,0,0,0
10/5/2020,五+六,文錦渡,出境,0,0,0,0
10/5/2020,五+六,沙頭角,入境,0,0,0,0
10/5/2020,五+六,沙頭角,出境,0,0,0,0
10/5/2020,五+六,深圳灣,入境,1783,201,4,1988
10/5/2020,五+六,深圳灣,出境,233,43,5,281
10/5/2020,五+六,中國客運碼頭,入境,0,0,0,0
10/5/2020,五+六,中國客運碼頭,出境,0,0,0,0
10/5/2020,五+六,港口管制,入境,0,0,0,0
10/5/2020,五+六,港口管制,出境,0,0,0,0
10/5/2020,五+六,啟德郵輪碼頭,入境,0,0,0,0
10/5/2020,五+六,啟德郵輪碼頭,出境,0,0,0,0
10/5/2020,五+六,港澳客輪碼頭,入境,0,0,0,0
10/5/2020,五+六,港澳客輪碼頭,出境,0,0,0,0
10/5/2020,五+六,屯門客運碼頭,入境,0,0,0,0
10/5/2020,五+六,屯門客運碼頭,出境,0,0,0,0
11/5/2020,五+六,機場,入境,797,7,30,834
11/5/2020,五+六,機場,出境,195,8,25,228
11/5/2020,五+六,高鐵西九龍,入境,0,0,0,0
11/5/2020,五+六,高鐵西九龍,出境,0,0,0,0
11/5/2020,五+六,紅磡,入境,0,0,0,0
11/5/2020,五+六,紅磡,出境,0,0,0,0
11/5/2020,五+六,羅湖,入境,0,0,0,0
11/5/2020,五+六,羅湖,出境,0,0,0,0
11/5/2020,五+六,落馬洲支線,入境,0,0,0,0
11/5/2020,五+六,落馬洲支線,出境,0,0,0,0
11/5/2020,五+六,港珠澳大橋,入境,167,3,7,177
11/5/2020,五+六,港珠澳大橋,出境,34,3,5,42
11/5/2020,五+六,落馬洲,入境,0,0,0,0
11/5/2020,五+六,落馬洲,出境,0,0,0,0
11/5/2020,五+六,文錦渡,入境,0,0,0,0
11/5/2020,五+六,文錦渡,出境,0,0,0,0
11/5/2020,五+六,沙頭角,入境,0,0,0,0
11/5/2020,五+六,沙頭角,出境,0,0,0,0
11/5/2020,五+六,深圳灣,入境,1886,175,6,2067
11/5/2020,五+六,深圳灣,出境,454,52,2,508
11/5/2020,五+六,中國客運碼頭,入境,0,0,0,0
11/5/2020,五+六,中國客運碼頭,出境,0,0,0,0
11/5/2020,五+六,港口管制,入境,0,0,0,0
11/5/2020,五+六,港口管制,出境,0,0,0,0
11/5/2020,五+六,啟德郵輪碼頭,入境,0,0,0,0
11/5/2020,五+六,啟德郵輪碼頭,出境,0,0,0,0
11/5/2020,五+六,港澳客輪碼頭,入境,0,0,0,0
11/5/2020,五+六,港澳客輪碼頭,出境,0,0,0,0
11/5/2020,五+六,屯門客運碼頭,入境,0,0,0,0
11/5/2020,五+六,屯門客運碼頭,出境,0,0,0,0
12/5/2020,五+六,機場,入境,452,5,33,490
12/5/2020,五+六,機場,出境,146,7,34,187
12/5/2020,五+六,高鐵西九龍,入境,0,0,0,0
12/5/2020,五+六,高鐵西九龍,出境,0,0,0,0
12/5/2020,五+六,紅磡,入境,0,0,0,0
12/5/2020,五+六,紅磡,出境,0,0,0,0
12/5/2020,五+六,羅湖,入境,0,0,0,0
12/5/2020,五+六,羅湖,出境,0,0,0,0
12/5/2020,五+六,落馬洲支線,入境,0,0,0,0
12/5/2020,五+六,落馬洲支線,出境,0,0,0,0
12/5/2020,五+六,港珠澳大橋,入境,180,6,6,192
12/5/2020,五+六,港珠澳大橋,出境,28,0,0,28
12/5/2020,五+六,落馬洲,入境,0,0,0,0
12/5/2020,五+六,落馬洲,出境,0,0,0,0
12/5/2020,五+六,文錦渡,入境,0,0,0,0
12/5/2020,五+六,文錦渡,出境,0,0,0,0
12/5/2020,五+六,沙頭角,入境,0,0,0,0
12/5/2020,五+六,沙頭角,出境,0,0,0,0
12/5/2020,五+六,深圳灣,入境,1906,184,6,2096
12/5/2020,五+六,深圳灣,出境,278,36,9,323
12/5/2020,五+六,中國客運碼頭,入境,0,0,0,0
12/5/2020,五+六,中國客運碼頭,出境,0,0,0,0
12/5/2020,五+六,港口管制,入境,0,0,0,0
12/5/2020,五+六,港口管制,出境,0,0,0,0
12/5/2020,五+六,啟德郵輪碼頭,入境,0,0,0,0
12/5/2020,五+六,啟德郵輪碼頭,出境,0,0,0,0
12/5/2020,五+六,港澳客輪碼頭,入境,0,0,0,0
12/5/2020,五+六,港澳客輪碼頭,出境,0,0,0,0
12/5/2020,五+六,屯門客運碼頭,入境,0,0,0,0
12/5/2020,五+六,屯門客運碼頭,出境,0,0,0,0
13/5/2020,五+六,機場,入境,600,13,24,637
13/5/2020,五+六,機場,出境,368,10,77,455
13/5/2020,五+六,高鐵西九龍,入境,0,0,0,0
13/5/2020,五+六,高鐵西九龍,出境,0,0,0,0
13/5/2020,五+六,紅磡,入境,0,0,0,0
13/5/2020,五+六,紅磡,出境,0,0,0,0
13/5/2020,五+六,羅湖,入境,0,0,0,0
13/5/2020,五+六,羅湖,出境,0,0,0,0
13/5/2020,五+六,落馬洲支線,入境,0,0,0,0
13/5/2020,五+六,落馬洲支線,出境,0,0,0,0
13/5/2020,五+六,港珠澳大橋,入境,118,5,1,124
13/5/2020,五+六,港珠澳大橋,出境,35,0,4,39
13/5/2020,五+六,落馬洲,入境,0,0,0,0
13/5/2020,五+六,落馬洲,出境,0,0,0,0
13/5/2020,五+六,文錦渡,入境,0,0,0,0
13/5/2020,五+六,文錦渡,出境,0,0,0,0
13/5/2020,五+六,沙頭角,入境,0,0,0,0
13/5/2020,五+六,沙頭角,出境,0,0,0,0
13/5/2020,五+六,深圳灣,入境,1149,112,8,1269
13/5/2020,五+六,深圳灣,出境,265,66,1,332
13/5/2020,五+六,中國客運碼頭,入境,0,0,0,0
13/5/2020,五+六,中國客運碼頭,出境,0,0,0,0
13/5/2020,五+六,港口管制,入境,0,0,0,0
13/5/2020,五+六,港口管制,出境,0,0,0,0
13/5/2020,五+六,啟德郵輪碼頭,入境,0,0,0,0
13/5/2020,五+六,啟德郵輪碼頭,出境,0,0,0,0
13/5/2020,五+六,港澳客輪碼頭,入境,0,0,0,0
13/5/2020,五+六,港澳客輪碼頭,出境,0,0,0,0
13/5/2020,五+六,屯門客運碼頭,入境,0,0,0,0
13/5/2020,五+六,屯門客運碼頭,出境,0,0,0,0
14/5/2020,五+六,機場,入境,597,3,32,632
14/5/2020,五+六,機場,出境,187,2,41,230
14/5/2020,五+六,高鐵西九龍,入境,0,0,0,0
14/5/2020,五+六,高鐵西九龍,出境,0,0,0,0
14/5/2020,五+六,紅磡,入境,0,0,0,0
14/5/2020,五+六,紅磡,出境,0,0,0,0
14/5/2020,五+六,羅湖,入境,0,0,0,0
14/5/2020,五+六,羅湖,出境,0,0,0,0
14/5/2020,五+六,落馬洲支線,入境,0,0,0,0
14/5/2020,五+六,落馬洲支線,出境,0,0,0,0
14/5/2020,五+六,港珠澳大橋,入境,119,5,11,135
14/5/2020,五+六,港珠澳大橋,出境,41,0,5,46
14/5/2020,五+六,落馬洲,入境,0,0,0,0
14/5/2020,五+六,落馬洲,出境,0,0,0,0
14/5/2020,五+六,文錦渡,入境,0,0,0,0
14/5/2020,五+六,文錦渡,出境,0,0,0,0
14/5/2020,五+六,沙頭角,入境,0,0,0,0
14/5/2020,五+六,沙頭角,出境,0,0,0,0
14/5/2020,五+六,深圳灣,入境,777,122,4,903
14/5/2020,五+六,深圳灣,出境,298,41,29,368
14/5/2020,五+六,中國客運碼頭,入境,0,0,0,0
14/5/2020,五+六,中國客運碼頭,出境,0,0,0,0
14/5/2020,五+六,港口管制,入境,0,0,0,0
14/5/2020,五+六,港口管制,出境,0,0,0,0
14/5/2020,五+六,啟德郵輪碼頭,入境,0,0,0,0
14/5/2020,五+六,啟德郵輪碼頭,出境,0,0,0,0
14/5/2020,五+六,港澳客輪碼頭,入境,0,0,0,0
14/5/2020,五+六,港澳客輪碼頭,出境,0,0,0,0
14/5/2020,五+六,屯門客運碼頭,入境,0,0,0,0
14/5/2020,五+六,屯門客運碼頭,出境,0,0,0,0
15/5/2020,五+六,機場,入境,939,3,31,973
15/5/2020,五+六,機場,出境,251,3,60,314
15/5/2020,五+六,高鐵西九龍,入境,0,0,0,0
15/5/2020,五+六,高鐵西九龍,出境,0,0,0,0
15/5/2020,五+六,紅磡,入境,0,0,0,0
15/5/2020,五+六,紅磡,出境,0,0,0,0
15/5/2020,五+六,羅湖,入境,0,0,0,0
15/5/2020,五+六,羅湖,出境,0,0,0,0
15/5/2020,五+六,落馬洲支線,入境,0,0,0,0
15/5/2020,五+六,落馬洲支線,出境,0,0,0,0
15/5/2020,五+六,港珠澳大橋,入境,102,9,8,119
15/5/2020,五+六,港珠澳大橋,出境,51,5,9,65
15/5/2020,五+六,落馬洲,入境,0,0,0,0
15/5/2020,五+六,落馬洲,出境,0,0,0,0
15/5/2020,五+六,文錦渡,入境,0,0,0,0
15/5/2020,五+六,文錦渡,出境,0,0,0,0
15/5/2020,五+六,沙頭角,入境,0,0,0,0
15/5/2020,五+六,沙頭角,出境,0,0,0,0
15/5/2020,五+六,深圳灣,入境,885,133,5,1023
15/5/2020,五+六,深圳灣,出境,293,55,1,349
15/5/2020,五+六,中國客運碼頭,入境,0,0,0,0
15/5/2020,五+六,中國客運碼頭,出境,0,0,0,0
15/5/2020,五+六,港口管制,入境,0,0,0,0
15/5/2020,五+六,港口管制,出境,0,0,0,0
15/5/2020,五+六,啟德郵輪碼頭,入境,0,0,0,0
15/5/2020,五+六,啟德郵輪碼頭,出境,0,0,0,0
15/5/2020,五+六,港澳客輪碼頭,入境,0,0,0,0
15/5/2020,五+六,港澳客輪碼頭,出境,0,0,0,0
15/5/2020,五+六,屯門客運碼頭,入境,0,0,0,0
15/5/2020,五+六,屯門客運碼頭,出境,0,0,0,0
16/5/2020,五+六,機場,入境,891,13,149,1053
16/5/2020,五+六,機場,出境,337,5,77,419
16/5/2020,五+六,高鐵西九龍,入境,0,0,0,0
16/5/2020,五+六,高鐵西九龍,出境,0,0,0,0
16/5/2020,五+六,紅磡,入境,0,0,0,0
16/5/2020,五+六,紅磡,出境,0,0,0,0
16/5/2020,五+六,羅湖,入境,0,0,0,0
16/5/2020,五+六,羅湖,出境,0,0,0,0
16/5/2020,五+六,落馬洲支線,入境,0,0,0,0
16/5/2020,五+六,落馬洲支線,出境,0,0,0,0
16/5/2020,五+六,港珠澳大橋,入境,80,6,7,93
16/5/2020,五+六,港珠澳大橋,出境,46,3,3,52
16/5/2020,五+六,落馬洲,入境,0,0,0,0
16/5/2020,五+六,落馬洲,出境,0,0,0,0
16/5/2020,五+六,文錦渡,入境,0,0,0,0
16/5/2020,五+六,文錦渡,出境,0,0,0,0
16/5/2020,五+六,沙頭角,入境,0,0,0,0
16/5/2020,五+六,沙頭角,出境,0,0,0,0
16/5/2020,五+六,深圳灣,入境,950,155,9,1114
16/5/2020,五+六,深圳灣,出境,311,45,3,359
16/5/2020,五+六,中國客運碼頭,入境,0,0,0,0
16/5/2020,五+六,中國客運碼頭,出境,0,0,0,0
16/5/2020,五+六,港口管制,入境,0,0,0,0
16/5/2020,五+六,港口管制,出境,0,0,0,0
16/5/2020,五+六,啟德郵輪碼頭,入境,0,0,0,0
16/5/2020,五+六,啟德郵輪碼頭,出境,0,0,0,0
16/5/2020,五+六,港澳客輪碼頭,入境,0,0,0,0
16/5/2020,五+六,港澳客輪碼頭,出境,0,0,0,0
16/5/2020,五+六,屯門客運碼頭,入境,0,0,0,0
16/5/2020,五+六,屯門客運碼頭,出境,0,0,0,0
17/5/2020,五+六,機場,入境,873,6,55,934
17/5/2020,五+六,機場,出境,221,7,61,289
17/5/2020,五+六,高鐵西九龍,入境,0,0,0,0
17/5/2020,五+六,高鐵西九龍,出境,0,0,0,0
17/5/2020,五+六,紅磡,入境,0,0,0,0
17/5/2020,五+六,紅磡,出境,0,0,0,0
17/5/2020,五+六,羅湖,入境,0,0,0,0
17/5/2020,五+六,羅湖,出境,0,0,0,0
17/5/2020,五+六,落馬洲支線,入境,0,0,0,0
17/5/2020,五+六,落馬洲支線,出境,0,0,0,0
17/5/2020,五+六,港珠澳大橋,入境,110,5,3,118
17/5/2020,五+六,港珠澳大橋,出境,30,4,1,35
17/5/2020,五+六,落馬洲,入境,0,0,0,0
17/5/2020,五+六,落馬洲,出境,0,0,0,0
17/5/2020,五+六,文錦渡,入境,0,0,0,0
17/5/2020,五+六,文錦渡,出境,0,0,0,0
17/5/2020,五+六,沙頭角,入境,0,0,0,0
17/5/2020,五+六,沙頭角,出境,0,0,0,0
17/5/2020,五+六,深圳灣,入境,1169,182,10,1361
17/5/2020,五+六,深圳灣,出境,195,40,1,236
17/5/2020,五+六,中國客運碼頭,入境,0,0,0,0
17/5/2020,五+六,中國客運碼頭,出境,0,0,0,0
17/5/2020,五+六,港口管制,入境,0,0,0,0
17/5/2020,五+六,港口管制,出境,0,0,0,0
17/5/2020,五+六,啟德郵輪碼頭,入境,0,0,0,0
17/5/2020,五+六,啟德郵輪碼頭,出境,0,0,0,0
17/5/2020,五+六,港澳客輪碼頭,入境,0,0,0,0
17/5/2020,五+六,港澳客輪碼頭,出境,0,0,0,0
17/5/2020,五+六,屯門客運碼頭,入境,0,0,0,0
17/5/2020,五+六,屯門客運碼頭,出境,0,0,0,0
18/5/2020,五+六,機場,入境,997,6,39,1042
18/5/2020,五+六,機場,出境,261,9,62,332
18/5/2020,五+六,高鐵西九龍,入境,0,0,0,0
18/5/2020,五+六,高鐵西九龍,出境,0,0,0,0
18/5/2020,五+六,紅磡,入境,0,0,0,0
18/5/2020,五+六,紅磡,出境,0,0,0,0
18/5/2020,五+六,羅湖,入境,0,0,0,0
18/5/2020,五+六,羅湖,出境,0,0,0,0
18/5/2020,五+六,落馬洲支線,入境,0,0,0,0
18/5/2020,五+六,落馬洲支線,出境,0,0,0,0
18/5/2020,五+六,港珠澳大橋,入境,84,6,14,104
18/5/2020,五+六,港珠澳大橋,出境,26,0,2,28
18/5/2020,五+六,落馬洲,入境,0,0,0,0
18/5/2020,五+六,落馬洲,出境,0,0,0,0
18/5/2020,五+六,文錦渡,入境,0,0,0,0
18/5/2020,五+六,文錦渡,出境,0,0,0,0
18/5/2020,五+六,沙頭角,入境,0,0,0,0
18/5/2020,五+六,沙頭角,出境,0,0,0,0
18/5/2020,五+六,深圳灣,入境,938,125,13,1076
18/5/2020,五+六,深圳灣,出境,348,39,2,389
18/5/2020,五+六,中國客運碼頭,入境,0,0,0,0
18/5/2020,五+六,中國客運碼頭,出境,0,0,0,0
18/5/2020,五+六,港口管制,入境,0,0,0,0
18/5/2020,五+六,港口管制,出境,0,0,0,0
18/5/2020,五+六,啟德郵輪碼頭,入境,0,0,0,0
18/5/2020,五+六,啟德郵輪碼頭,出境,0,0,0,0
18/5/2020,五+六,港澳客輪碼頭,入境,0,0,0,0
18/5/2020,五+六,港澳客輪碼頭,出境,0,0,0,0
18/5/2020,五+六,屯門客運碼頭,入境,0,0,0,0
18/5/2020,五+六,屯門客運碼頭,出境,0,0,0,0
19/5/2020,五+六,機場,入境,385,0,14,399
19/5/2020,五+六,機場,出境,144,2,18,164
19/5/2020,五+六,高鐵西九龍,入境,0,0,0,0
19/5/2020,五+六,高鐵西九龍,出境,0,0,0,0
19/5/2020,五+六,紅磡,入境,0,0,0,0
19/5/2020,五+六,紅磡,出境,0,0,0,0
19/5/2020,五+六,羅湖,入境,0,0,0,0
19/5/2020,五+六,羅湖,出境,0,0,0,0
19/5/2020,五+六,落馬洲支線,入境,0,0,0,0
19/5/2020,五+六,落馬洲支線,出境,0,0,0,0
19/5/2020,五+六,港珠澳大橋,入境,68,5,10,83
19/5/2020,五+六,港珠澳大橋,出境,20,1,1,22
19/5/2020,五+六,落馬洲,入境,0,0,0,0
19/5/2020,五+六,落馬洲,出境,0,0,0,0
19/5/2020,五+六,文錦渡,入境,0,0,0,0
19/5/2020,五+六,文錦渡,出境,0,0,0,0
19/5/2020,五+六,沙頭角,入境,0,0,0,0
19/5/2020,五+六,沙頭角,出境,0,0,0,0
19/5/2020,五+六,深圳灣,入境,889,115,8,1012
19/5/2020,五+六,深圳灣,出境,454,37,5,496
19/5/2020,五+六,中國客運碼頭,入境,0,0,0,0
19/5/2020,五+六,中國客運碼頭,出境,0,0,0,0
19/5/2020,五+六,港口管制,入境,0,0,0,0
19/5/2020,五+六,港口管制,出境,0,0,0,0
19/5/2020,五+六,啟德郵輪碼頭,入境,0,0,0,0
19/5/2020,五+六,啟德郵輪碼頭,出境,0,0,0,0
19/5/2020,五+六,港澳客輪碼頭,入境,0,0,0,0
19/5/2020,五+六,港澳客輪碼頭,出境,0,0,0,0
19/5/2020,五+六,屯門客運碼頭,入境,0,0,0,0
19/5/2020,五+六,屯門客運碼頭,出境,0,0,0,0
20/5/2020,五+六,機場,入境,787,5,20,812
20/5/2020,五+六,機場,出境,230,8,26,264
20/5/2020,五+六,高鐵西九龍,入境,0,0,0,0
20/5/2020,五+六,高鐵西九龍,出境,0,0,0,0
20/5/2020,五+六,紅磡,入境,0,0,0,0
20/5/2020,五+六,紅磡,出境,0,0,0,0
20/5/2020,五+六,羅湖,入境,0,0,0,0
20/5/2020,五+六,羅湖,出境,0,0,0,0
20/5/2020,五+六,落馬洲支線,入境,0,0,0,0
20/5/2020,五+六,落馬洲支線,出境,0,0,0,0
20/5/2020,五+六,港珠澳大橋,入境,70,9,6,85
20/5/2020,五+六,港珠澳大橋,出境,22,3,1,26
20/5/2020,五+六,落馬洲,入境,0,0,0,0
20/5/2020,五+六,落馬洲,出境,0,0,0,0
20/5/2020,五+六,文錦渡,入境,0,0,0,0
20/5/2020,五+六,文錦渡,出境,0,0,0,0
20/5/2020,五+六,沙頭角,入境,0,0,0,0
20/5/2020,五+六,沙頭角,出境,0,0,0,0
20/5/2020,五+六,深圳灣,入境,1019,135,13,1167
20/5/2020,五+六,深圳灣,出境,262,41,1,304
20/5/2020,五+六,中國客運碼頭,入境,0,0,0,0
20/5/2020,五+六,中國客運碼頭,出境,0,0,0,0
20/5/2020,五+六,港口管制,入境,0,0,0,0
20/5/2020,五+六,港口管制,出境,0,0,0,0
20/5/2020,五+六,啟德郵輪碼頭,入境,0,0,0,0
20/5/2020,五+六,啟德郵輪碼頭,出境,0,0,0,0
20/5/2020,五+六,港澳客輪碼頭,入境,0,0,0,0
20/5/2020,五+六,港澳客輪碼頭,出境,0,0,0,0
20/5/2020,五+六,屯門客運碼頭,入境,0,0,0,0
20/5/2020,五+六,屯門客運碼頭,出境,0,0,0,0
21/5/2020,五+六,機場,入境,474,8,30,512
21/5/2020,五+六,機場,出境,147,8,32,187
21/5/2020,五+六,高鐵西九龍,入境,0,0,0,0
21/5/2020,五+六,高鐵西九龍,出境,0,0,0,0
21/5/2020,五+六,紅磡,入境,0,0,0,0
21/5/2020,五+六,紅磡,出境,0,0,0,0
21/5/2020,五+六,羅湖,入境,0,0,0,0
21/5/2020,五+六,羅湖,出境,0,0,0,0
21/5/2020,五+六,落馬洲支線,入境,0,0,0,0
21/5/2020,五+六,落馬洲支線,出境,0,0,0,0
21/5/2020,五+六,港珠澳大橋,入境,106,4,5,115
21/5/2020,五+六,港珠澳大橋,出境,23,1,2,26
21/5/2020,五+六,落馬洲,入境,0,0,0,0
21/5/2020,五+六,落馬洲,出境,0,0,0,0
21/5/2020,五+六,文錦渡,入境,0,0,0,0
21/5/2020,五+六,文錦渡,出境,0,0,0,0
21/5/2020,五+六,沙頭角,入境,0,0,0,0
21/5/2020,五+六,沙頭角,出境,0,0,0,0
21/5/2020,五+六,深圳灣,入境,1121,127,9,1257
21/5/2020,五+六,深圳灣,出境,256,79,1,336
21/5/2020,五+六,中國客運碼頭,入境,0,0,0,0
21/5/2020,五+六,中國客運碼頭,出境,0,0,0,0
21/5/2020,五+六,港口管制,入境,0,0,0,0
21/5/2020,五+六,港口管制,出境,0,0,0,0
21/5/2020,五+六,啟德郵輪碼頭,入境,0,0,0,0
21/5/2020,五+六,啟德郵輪碼頭,出境,0,0,0,0
21/5/2020,五+六,港澳客輪碼頭,入境,0,0,0,0
21/5/2020,五+六,港澳客輪碼頭,出境,0,0,0,0
21/5/2020,五+六,屯門客運碼頭,入境,0,0,0,0
21/5/2020,五+六,屯門客運碼頭,出境,0,0,0,0
22/5/2020,五+六,機場,入境,1089,7,31,1127
22/5/2020,五+六,機場,出境,336,4,55,395
22/5/2020,五+六,高鐵西九龍,入境,0,0,0,0
22/5/2020,五+六,高鐵西九龍,出境,0,0,0,0
22/5/2020,五+六,紅磡,入境,0,0,0,0
22/5/2020,五+六,紅磡,出境,0,0,0,0
22/5/2020,五+六,羅湖,入境,0,0,0,0
22/5/2020,五+六,羅湖,出境,0,0,0,0
22/5/2020,五+六,落馬洲支線,入境,0,0,0,0
22/5/2020,五+六,落馬洲支線,出境,0,0,0,0
22/5/2020,五+六,港珠澳大橋,入境,69,4,4,77
22/5/2020,五+六,港珠澳大橋,出境,31,1,1,33
22/5/2020,五+六,落馬洲,入境,0,0,0,0
22/5/2020,五+六,落馬洲,出境,0,0,0,0
22/5/2020,五+六,文錦渡,入境,0,0,0,0
22/5/2020,五+六,文錦渡,出境,0,0,0,0
22/5/2020,五+六,沙頭角,入境,0,0,0,0
22/5/2020,五+六,沙頭角,出境,0,0,0,0
22/5/2020,五+六,深圳灣,入境,1121,154,17,1292
22/5/2020,五+六,深圳灣,出境,300,70,1,371
22/5/2020,五+六,中國客運碼頭,入境,0,0,0,0
22/5/2020,五+六,中國客運碼頭,出境,0,0,0,0
22/5/2020,五+六,港口管制,入境,0,0,0,0
22/5/2020,五+六,港口管制,出境,0,0,0,0
22/5/2020,五+六,啟德郵輪碼頭,入境,0,0,0,0
22/5/2020,五+六,啟德郵輪碼頭,出境,0,0,0,0
22/5/2020,五+六,港澳客輪碼頭,入境,0,0,0,0
22/5/2020,五+六,港澳客輪碼頭,出境,0,0,0,0
22/5/2020,五+六,屯門客運碼頭,入境,0,0,0,0
22/5/2020,五+六,屯門客運碼頭,出境,0,0,0,0
23/5/2020,五+六,機場,入境,534,5,102,641
23/5/2020,五+六,機場,出境,202,12,35,249
23/5/2020,五+六,高鐵西九龍,入境,0,0,0,0
23/5/2020,五+六,高鐵西九龍,出境,0,0,0,0
23/5/2020,五+六,紅磡,入境,0,0,0,0
23/5/2020,五+六,紅磡,出境,0,0,0,0
23/5/2020,五+六,羅湖,入境,0,0,0,0
23/5/2020,五+六,羅湖,出境,0,0,0,0
23/5/2020,五+六,落馬洲支線,入境,0,0,0,0
23/5/2020,五+六,落馬洲支線,出境,0,0,0,0
23/5/2020,五+六,港珠澳大橋,入境,118,12,3,133
23/5/2020,五+六,港珠澳大橋,出境,10,1,6,17
23/5/2020,五+六,落馬洲,入境,0,0,0,0
23/5/2020,五+六,落馬洲,出境,0,0,0,0
23/5/2020,五+六,文錦渡,入境,0,0,0,0
23/5/2020,五+六,文錦渡,出境,0,0,0,0
23/5/2020,五+六,沙頭角,入境,0,0,0,0
23/5/2020,五+六,沙頭角,出境,0,0,0,0
23/5/2020,五+六,深圳灣,入境,1802,270,11,2083
23/5/2020,五+六,深圳灣,出境,210,39,11,260
23/5/2020,五+六,中國客運碼頭,入境,0,0,0,0
23/5/2020,五+六,中國客運碼頭,出境,0,0,0,0
23/5/2020,五+六,港口管制,入境,0,0,0,0
23/5/2020,五+六,港口管制,出境,0,0,0,0
23/5/2020,五+六,啟德郵輪碼頭,入境,0,0,0,0
23/5/2020,五+六,啟德郵輪碼頭,出境,0,0,0,0
23/5/2020,五+六,港澳客輪碼頭,入境,0,0,0,0
23/5/2020,五+六,港澳客輪碼頭,出境,0,0,0,0
23/5/2020,五+六,屯門客運碼頭,入境,0,0,0,0
23/5/2020,五+六,屯門客運碼頭,出境,0,0,0,0
24/5/2020,五+六,機場,入境,1048,10,38,1096
24/5/2020,五+六,機場,出境,237,9,40,286
24/5/2020,五+六,高鐵西九龍,入境,0,0,0,0
24/5/2020,五+六,高鐵西九龍,出境,0,0,0,0
24/5/2020,五+六,紅磡,入境,0,0,0,0
24/5/2020,五+六,紅磡,出境,0,0,0,0
24/5/2020,五+六,羅湖,入境,0,0,0,0
24/5/2020,五+六,羅湖,出境,0,0,0,0
24/5/2020,五+六,落馬洲支線,入境,0,0,0,0
24/5/2020,五+六,落馬洲支線,出境,0,0,0,0
24/5/2020,五+六,港珠澳大橋,入境,123,15,2,140
24/5/2020,五+六,港珠澳大橋,出境,27,0,2,29
24/5/2020,五+六,落馬洲,入境,0,0,0,0
24/5/2020,五+六,落馬洲,出境,0,0,0,0
24/5/2020,五+六,文錦渡,入境,0,0,0,0
24/5/2020,五+六,文錦渡,出境,0,0,0,0
24/5/2020,五+六,沙頭角,入境,0,0,0,0
24/5/2020,五+六,沙頭角,出境,0,0,0,0
24/5/2020,五+六,深圳灣,入境,2458,439,14,2911
24/5/2020,五+六,深圳灣,出境,210,35,3,248
24/5/2020,五+六,中國客運碼頭,入境,0,0,0,0
24/5/2020,五+六,中國客運碼頭,出境,0,0,0,0
24/5/2020,五+六,港口管制,入境,0,0,0,0
24/5/2020,五+六,港口管制,出境,0,0,0,0
24/5/2020,五+六,啟德郵輪碼頭,入境,0,0,0,0
24/5/2020,五+六,啟德郵輪碼頭,出境,0,0,0,0
24/5/2020,五+六,港澳客輪碼頭,入境,0,0,0,0
24/5/2020,五+六,港澳客輪碼頭,出境,0,0,0,0
24/5/2020,五+六,屯門客運碼頭,入境,0,0,0,0
24/5/2020,五+六,屯門客運碼頭,出境,0,0,0,0
25/5/2020,五+六,機場,入境,673,6,46,725
25/5/2020,五+六,機場,出境,156,4,23,183
25/5/2020,五+六,高鐵西九龍,入境,0,0,0,0
25/5/2020,五+六,高鐵西九龍,出境,0,0,0,0
25/5/2020,五+六,紅磡,入境,0,0,0,0
25/5/2020,五+六,紅磡,出境,0,0,0,0
25/5/2020,五+六,羅湖,入境,0,0,0,0
25/5/2020,五+六,羅湖,出境,0,0,0,0
25/5/2020,五+六,落馬洲支線,入境,0,0,0,0
25/5/2020,五+六,落馬洲支線,出境,0,0,0,0
25/5/2020,五+六,港珠澳大橋,入境,99,8,8,115
25/5/2020,五+六,港珠澳大橋,出境,48,0,3,51
25/5/2020,五+六,落馬洲,入境,0,0,0,0
25/5/2020,五+六,落馬洲,出境,0,0,0,0
25/5/2020,五+六,文錦渡,入境,0,0,0,0
25/5/2020,五+六,文錦渡,出境,0,0,0,0
25/5/2020,五+六,沙頭角,入境,0,0,0,0
25/5/2020,五+六,沙頭角,出境,0,0,0,0
25/5/2020,五+六,深圳灣,入境,1469,255,6,1730
25/5/2020,五+六,深圳灣,出境,376,18,6,400
25/5/2020,五+六,中國客運碼頭,入境,0,0,0,0
25/5/2020,五+六,中國客運碼頭,出境,0,0,0,0
25/5/2020,五+六,港口管制,入境,0,0,0,0
25/5/2020,五+六,港口管制,出境,0,0,0,0
25/5/2020,五+六,啟德郵輪碼頭,入境,0,0,0,0
25/5/2020,五+六,啟德郵輪碼頭,出境,0,0,0,0
25/5/2020,五+六,港澳客輪碼頭,入境,0,0,0,0
25/5/2020,五+六,港澳客輪碼頭,出境,0,0,0,0
25/5/2020,五+六,屯門客運碼頭,入境,0,0,0,0
25/5/2020,五+六,屯門客運碼頭,出境,0,0,0,0
26/5/2020,五+六,機場,入境,543,2,37,582
26/5/2020,五+六,機場,出境,252,3,53,308
26/5/2020,五+六,高鐵西九龍,入境,0,0,0,0
26/5/2020,五+六,高鐵西九龍,出境,0,0,0,0
26/5/2020,五+六,紅磡,入境,0,0,0,0
26/5/2020,五+六,紅磡,出境,0,0,0,0
26/5/2020,五+六,羅湖,入境,0,0,0,0
26/5/2020,五+六,羅湖,出境,0,0,0,0
26/5/2020,五+六,落馬洲支線,入境,0,0,0,0
26/5/2020,五+六,落馬洲支線,出境,0,0,0,0
26/5/2020,五+六,港珠澳大橋,入境,60,11,8,79
26/5/2020,五+六,港珠澳大橋,出境,23,0,2,25
26/5/2020,五+六,落馬洲,入境,0,0,0,0
26/5/2020,五+六,落馬洲,出境,0,0,0,0
26/5/2020,五+六,文錦渡,入境,0,0,0,0
26/5/2020,五+六,文錦渡,出境,0,0,0,0
26/5/2020,五+六,沙頭角,入境,0,0,0,0
26/5/2020,五+六,沙頭角,出境,0,0,0,0
26/5/2020,五+六,深圳灣,入境,790,142,12,944
26/5/2020,五+六,深圳灣,出境,213,31,2,246
26/5/2020,五+六,中國客運碼頭,入境,0,0,0,0
26/5/2020,五+六,中國客運碼頭,出境,0,0,0,0
26/5/2020,五+六,港口管制,入境,0,0,0,0
26/5/2020,五+六,港口管制,出境,0,0,0,0
26/5/2020,五+六,啟德郵輪碼頭,入境,0,0,0,0
26/5/2020,五+六,啟德郵輪碼頭,出境,0,0,0,0
26/5/2020,五+六,港澳客輪碼頭,入境,0,0,0,0
26/5/2020,五+六,港澳客輪碼頭,出境,0,0,0,0
26/5/2020,五+六,屯門客運碼頭,入境,0,0,0,0
26/5/2020,五+六,屯門客運碼頭,出境,0,0,0,0
27/5/2020,五+六,機場,入境,485,4,21,510
27/5/2020,五+六,機場,出境,331,9,149,489
27/5/2020,五+六,高鐵西九龍,入境,0,0,0,0
27/5/2020,五+六,高鐵西九龍,出境,0,0,0,0
27/5/2020,五+六,紅磡,入境,0,0,0,0
27/5/2020,五+六,紅磡,出境,0,0,0,0
27/5/2020,五+六,羅湖,入境,0,0,0,0
27/5/2020,五+六,羅湖,出境,0,0,0,0
27/5/2020,五+六,落馬洲支線,入境,0,0,0,0
27/5/2020,五+六,落馬洲支線,出境,0,0,0,0
27/5/2020,五+六,港珠澳大橋,入境,51,9,5,65
27/5/2020,五+六,港珠澳大橋,出境,17,0,0,17
27/5/2020,五+六,落馬洲,入境,0,0,0,0
27/5/2020,五+六,落馬洲,出境,0,0,0,0
27/5/2020,五+六,文錦渡,入境,0,0,0,0
27/5/2020,五+六,文錦渡,出境,0,0,0,0
27/5/2020,五+六,沙頭角,入境,0,0,0,0
27/5/2020,五+六,沙頭角,出境,0,0,0,0
27/5/2020,五+六,深圳灣,入境,694,107,4,805
27/5/2020,五+六,深圳灣,出境,247,34,0,281
27/5/2020,五+六,中國客運碼頭,入境,0,0,0,0
27/5/2020,五+六,中國客運碼頭,出境,0,0,0,0
27/5/2020,五+六,港口管制,入境,0,0,0,0
27/5/2020,五+六,港口管制,出境,0,0,0,0
27/5/2020,五+六,啟德郵輪碼頭,入境,0,0,0,0
27/5/2020,五+六,啟德郵輪碼頭,出境,0,0,0,0
27/5/2020,五+六,港澳客輪碼頭,入境,0,0,0,0
27/5/2020,五+六,港澳客輪碼頭,出境,0,0,0,0
27/5/2020,五+六,屯門客運碼頭,入境,0,0,0,0
27/5/2020,五+六,屯門客運碼頭,出境,0,0,0,0
28/5/2020,五+六,機場,入境,661,2,29,692
28/5/2020,五+六,機場,出境,195,7,71,273
28/5/2020,五+六,高鐵西九龍,入境,0,0,0,0
28/5/2020,五+六,高鐵西九龍,出境,0,0,0,0
28/5/2020,五+六,紅磡,入境,0,0,0,0
28/5/2020,五+六,紅磡,出境,0,0,0,0
28/5/2020,五+六,羅湖,入境,0,0,0,0
28/5/2020,五+六,羅湖,出境,0,0,0,0
28/5/2020,五+六,落馬洲支線,入境,0,0,0,0
28/5/2020,五+六,落馬洲支線,出境,0,0,0,0
28/5/2020,五+六,港珠澳大橋,入境,39,0,41,80
28/5/2020,五+六,港珠澳大橋,出境,17,0,0,17
28/5/2020,五+六,落馬洲,入境,0,0,0,0
28/5/2020,五+六,落馬洲,出境,0,0,0,0
28/5/2020,五+六,文錦渡,入境,0,0,0,0
28/5/2020,五+六,文錦渡,出境,0,0,0,0
28/5/2020,五+六,沙頭角,入境,0,0,0,0
28/5/2020,五+六,沙頭角,出境,0,0,0,0
28/5/2020,五+六,深圳灣,入境,676,114,10,800
28/5/2020,五+六,深圳灣,出境,216,27,2,245
28/5/2020,五+六,中國客運碼頭,入境,0,0,0,0
28/5/2020,五+六,中國客運碼頭,出境,0,0,0,0
28/5/2020,五+六,港口管制,入境,0,0,0,0
28/5/2020,五+六,港口管制,出境,0,0,0,0
28/5/2020,五+六,啟德郵輪碼頭,入境,0,0,0,0
28/5/2020,五+六,啟德郵輪碼頭,出境,0,0,0,0
28/5/2020,五+六,港澳客輪碼頭,入境,0,0,0,0
28/5/2020,五+六,港澳客輪碼頭,出境,0,0,0,0
28/5/2020,五+六,屯門客運碼頭,入境,0,0,0,0
28/5/2020,五+六,屯門客運碼頭,出境,0,0,0,0
29/5/2020,五+六,機場,入境,923,4,22,949
29/5/2020,五+六,機場,出境,264,2,65,331
29/5/2020,五+六,高鐵西九龍,入境,0,0,0,0
29/5/2020,五+六,高鐵西九龍,出境,0,0,0,0
29/5/2020,五+六,紅磡,入境,0,0,0,0
29/5/2020,五+六,紅磡,出境,0,0,0,0
29/5/2020,五+六,羅湖,入境,0,0,0,0
29/5/2020,五+六,羅湖,出境,0,0,0,0
29/5/2020,五+六,落馬洲支線,入境,0,0,0,0
29/5/2020,五+六,落馬洲支線,出境,0,0,0,0
29/5/2020,五+六,港珠澳大橋,入境,71,4,15,90
29/5/2020,五+六,港珠澳大橋,出境,13,0,3,16
29/5/2020,五+六,落馬洲,入境,0,0,0,0
29/5/2020,五+六,落馬洲,出境,0,0,0,0
29/5/2020,五+六,文錦渡,入境,0,0,0,0
29/5/2020,五+六,文錦渡,出境,0,0,0,0
29/5/2020,五+六,沙頭角,入境,0,0,0,0
29/5/2020,五+六,沙頭角,出境,0,0,0,0
29/5/2020,五+六,深圳灣,入境,695,106,8,809
29/5/2020,五+六,深圳灣,出境,209,24,53,286
29/5/2020,五+六,中國客運碼頭,入境,0,0,0,0
29/5/2020,五+六,中國客運碼頭,出境,0,0,0,0
29/5/2020,五+六,港口管制,入境,0,0,0,0
29/5/2020,五+六,港口管制,出境,0,0,0,0
29/5/2020,五+六,啟德郵輪碼頭,入境,0,0,0,0
29/5/2020,五+六,啟德郵輪碼頭,出境,0,0,0,0
29/5/2020,五+六,港澳客輪碼頭,入境,0,0,0,0
29/5/2020,五+六,港澳客輪碼頭,出境,0,0,0,0
29/5/2020,五+六,屯門客運碼頭,入境,0,0,0,0
29/5/2020,五+六,屯門客運碼頭,出境,0,0,0,0
30/5/2020,五+六,機場,入境,599,7,35,641
30/5/2020,五+六,機場,出境,414,7,48,469
30/5/2020,五+六,高鐵西九龍,入境,0,0,0,0
30/5/2020,五+六,高鐵西九龍,出境,0,0,0,0
30/5/2020,五+六,紅磡,入境,0,0,0,0
30/5/2020,五+六,紅磡,出境,0,0,0,0
30/5/2020,五+六,羅湖,入境,0,0,0,0
30/5/2020,五+六,羅湖,出境,0,0,0,0
30/5/2020,五+六,落馬洲支線,入境,0,0,0,0
30/5/2020,五+六,落馬洲支線,出境,0,0,0,0
30/5/2020,五+六,港珠澳大橋,入境,57,5,2,64
30/5/2020,五+六,港珠澳大橋,出境,16,1,1,18
30/5/2020,五+六,落馬洲,入境,0,0,0,0
30/5/2020,五+六,落馬洲,出境,0,0,0,0
30/5/2020,五+六,文錦渡,入境,0,0,0,0
30/5/2020,五+六,文錦渡,出境,0,0,0,0
30/5/2020,五+六,沙頭角,入境,0,0,0,0
30/5/2020,五+六,沙頭角,出境,0,0,0,0
30/5/2020,五+六,深圳灣,入境,985,149,12,1146
30/5/2020,五+六,深圳灣,出境,133,37,45,215
30/5/2020,五+六,中國客運碼頭,入境,0,0,0,0
30/5/2020,五+六,中國客運碼頭,出境,0,0,0,0
30/5/2020,五+六,港口管制,入境,0,0,0,0
30/5/2020,五+六,港口管制,出境,0,0,0,0
30/5/2020,五+六,啟德郵輪碼頭,入境,0,0,0,0
30/5/2020,五+六,啟德郵輪碼頭,出境,0,0,0,0
30/5/2020,五+六,港澳客輪碼頭,入境,0,0,0,0
30/5/2020,五+六,港澳客輪碼頭,出境,0,0,0,0
30/5/2020,五+六,屯門客運碼頭,入境,0,0,0,0
30/5/2020,五+六,屯門客運碼頭,出境,0,0,0,0
31/5/2020,五+六,機場,入境,839,8,41,888
31/5/2020,五+六,機場,出境,191,4,38,233
31/5/2020,五+六,高鐵西九龍,入境,0,0,0,0
31/5/2020,五+六,高鐵西九龍,出境,0,0,0,0
31/5/2020,五+六,紅磡,入境,0,0,0,0
31/5/2020,五+六,紅磡,出境,0,0,0,0
31/5/2020,五+六,羅湖,入境,0,0,0,0
31/5/2020,五+六,羅湖,出境,0,0,0,0
31/5/2020,五+六,落馬洲支線,入境,0,0,0,0
31/5/2020,五+六,落馬洲支線,出境,0,0,0,0
31/5/2020,五+六,港珠澳大橋,入境,83,11,6,100
31/5/2020,五+六,港珠澳大橋,出境,17,0,0,17
31/5/2020,五+六,落馬洲,入境,0,0,0,0
31/5/2020,五+六,落馬洲,出境,0,0,0,0
31/5/2020,五+六,文錦渡,入境,0,0,0,0
31/5/2020,五+六,文錦渡,出境,0,0,0,0
31/5/2020,五+六,沙頭角,入境,0,0,0,0
31/5/2020,五+六,沙頭角,出境,0,0,0,0
31/5/2020,五+六,深圳灣,入境,1304,278,11,1593
31/5/2020,五+六,深圳灣,出境,156,21,17,194
31/5/2020,五+六,中國客運碼頭,入境,0,0,0,0
31/5/2020,五+六,中國客運碼頭,出境,0,0,0,0
31/5/2020,五+六,港口管制,入境,0,0,0,0
31/5/2020,五+六,港口管制,出境,0,0,0,0
31/5/2020,五+六,啟德郵輪碼頭,入境,0,0,0,0
31/5/2020,五+六,啟德郵輪碼頭,出境,0,0,0,0
31/5/2020,五+六,港澳客輪碼頭,入境,0,0,0,0
31/5/2020,五+六,港澳客輪碼頭,出境,0,0,0,0
31/5/2020,五+六,屯門客運碼頭,入境,0,0,0,0
31/5/2020,五+六,屯門客運碼頭,出境,0,0,0,0
1/6/2020,五+六,機場,入境,760,9,61,830
1/6/2020,五+六,機場,出境,253,1,40,294
1/6/2020,五+六,高鐵西九龍,入境,0,0,0,0
1/6/2020,五+六,高鐵西九龍,出境,0,0,0,0
1/6/2020,五+六,紅磡,入境,0,0,0,0
1/6/2020,五+六,紅磡,出境,0,0,0,0
1/6/2020,五+六,羅湖,入境,0,0,0,0
1/6/2020,五+六,羅湖,出境,0,0,0,0
1/6/2020,五+六,落馬洲支線,入境,0,0,0,0
1/6/2020,五+六,落馬洲支線,出境,0,0,0,0
1/6/2020,五+六,港珠澳大橋,入境,86,10,4,100
1/6/2020,五+六,港珠澳大橋,出境,40,3,3,46
1/6/2020,五+六,落馬洲,入境,0,0,0,0
1/6/2020,五+六,落馬洲,出境,0,0,0,0
1/6/2020,五+六,文錦渡,入境,0,0,0,0
1/6/2020,五+六,文錦渡,出境,0,0,0,0
1/6/2020,五+六,沙頭角,入境,0,0,0,0
1/6/2020,五+六,沙頭角,出境,0,0,0,0
1/6/2020,五+六,深圳灣,入境,984,166,15,1165
1/6/2020,五+六,深圳灣,出境,357,25,9,391
1/6/2020,五+六,中國客運碼頭,入境,0,0,0,0
1/6/2020,五+六,中國客運碼頭,出境,0,0,0,0
1/6/2020,五+六,港口管制,入境,0,0,0,0
1/6/2020,五+六,港口管制,出境,0,0,0,0
1/6/2020,五+六,啟德郵輪碼頭,入境,0,0,0,0
1/6/2020,五+六,啟德郵輪碼頭,出境,0,0,0,0
1/6/2020,五+六,港澳客輪碼頭,入境,0,0,0,0
1/6/2020,五+六,港澳客輪碼頭,出境,0,0,0,0
1/6/2020,五+六,屯門客運碼頭,入境,0,0,0,0
1/6/2020,五+六,屯門客運碼頭,出境,0,0,0,0
2/6/2020,五+六,機場,入境,1150,4,52,1206
2/6/2020,五+六,機場,出境,367,2,110,479
2/6/2020,五+六,高鐵西九龍,入境,0,0,0,0
2/6/2020,五+六,高鐵西九龍,出境,0,0,0,0
2/6/2020,五+六,紅磡,入境,0,0,0,0
2/6/2020,五+六,紅磡,出境,0,0,0,0
2/6/2020,五+六,羅湖,入境,0,0,0,0
2/6/2020,五+六,羅湖,出境,0,0,0,0
2/6/2020,五+六,落馬洲支線,入境,0,0,0,0
2/6/2020,五+六,落馬洲支線,出境,0,0,0,0
2/6/2020,五+六,港珠澳大橋,入境,70,4,4,78
2/6/2020,五+六,港珠澳大橋,出境,32,1,3,36
2/6/2020,五+六,落馬洲,入境,0,0,0,0
2/6/2020,五+六,落馬洲,出境,0,0,0,0
2/6/2020,五+六,文錦渡,入境,0,0,0,0
2/6/2020,五+六,文錦渡,出境,0,0,0,0
2/6/2020,五+六,沙頭角,入境,0,0,0,0
2/6/2020,五+六,沙頭角,出境,0,0,0,0
2/6/2020,五+六,深圳灣,入境,576,108,17,701
2/6/2020,五+六,深圳灣,出境,267,30,4,301
2/6/2020,五+六,中國客運碼頭,入境,0,0,0,0
2/6/2020,五+六,中國客運碼頭,出境,0,0,0,0
2/6/2020,五+六,港口管制,入境,0,0,0,0
2/6/2020,五+六,港口管制,出境,0,0,0,0
2/6/2020,五+六,啟德郵輪碼頭,入境,0,0,0,0
2/6/2020,五+六,啟德郵輪碼頭,出境,0,0,0,0
2/6/2020,五+六,港澳客輪碼頭,入境,0,0,0,0
2/6/2020,五+六,港澳客輪碼頭,出境,0,0,0,0
2/6/2020,五+六,屯門客運碼頭,入境,0,0,0,0
2/6/2020,五+六,屯門客運碼頭,出境,0,0,0,0
3/6/2020,五+六,機場,入境,918,5,40,963
3/6/2020,五+六,機場,出境,404,12,120,536
3/6/2020,五+六,高鐵西九龍,入境,0,0,0,0
3/6/2020,五+六,高鐵西九龍,出境,0,0,0,0
3/6/2020,五+六,紅磡,入境,0,0,0,0
3/6/2020,五+六,紅磡,出境,0,0,0,0
3/6/2020,五+六,羅湖,入境,0,0,0,0
3/6/2020,五+六,羅湖,出境,0,0,0,0
3/6/2020,五+六,落馬洲支線,入境,0,0,0,0
3/6/2020,五+六,落馬洲支線,出境,0,0,0,0
3/6/2020,五+六,港珠澳大橋,入境,97,6,4,107
3/6/2020,五+六,港珠澳大橋,出境,64,0,2,66
3/6/2020,五+六,落馬洲,入境,0,0,0,0
3/6/2020,五+六,落馬洲,出境,0,0,0,0
3/6/2020,五+六,文錦渡,入境,0,0,0,0
3/6/2020,五+六,文錦渡,出境,0,0,0,0
3/6/2020,五+六,沙頭角,入境,0,0,0,0
3/6/2020,五+六,沙頭角,出境,0,0,0,0
3/6/2020,五+六,深圳灣,入境,1147,196,6,1349
3/6/2020,五+六,深圳灣,出境,609,88,2,699
3/6/2020,五+六,中國客運碼頭,入境,0,0,0,0
3/6/2020,五+六,中國客運碼頭,出境,0,0,0,0
3/6/2020,五+六,港口管制,入境,0,0,0,0
3/6/2020,五+六,港口管制,出境,0,0,0,0
3/6/2020,五+六,啟德郵輪碼頭,入境,0,0,0,0
3/6/2020,五+六,啟德郵輪碼頭,出境,0,0,0,0
3/6/2020,五+六,港澳客輪碼頭,入境,0,0,0,0
3/6/2020,五+六,港澳客輪碼頭,出境,0,0,0,0
3/6/2020,五+六,屯門客運碼頭,入境,0,0,0,0
3/6/2020,五+六,屯門客運碼頭,出境,0,0,0,0
4/6/2020,五+六,機場,入境,952,6,36,994
4/6/2020,五+六,機場,出境,440,5,80,525
4/6/2020,五+六,高鐵西九龍,入境,0,0,0,0
4/6/2020,五+六,高鐵西九龍,出境,0,0,0,0
4/6/2020,五+六,紅磡,入境,0,0,0,0
4/6/2020,五+六,紅磡,出境,0,0,0,0
4/6/2020,五+六,羅湖,入境,0,0,0,0
4/6/2020,五+六,羅湖,出境,0,0,0,0
4/6/2020,五+六,落馬洲支線,入境,0,0,0,0
4/6/2020,五+六,落馬洲支線,出境,0,0,0,0
4/6/2020,五+六,港珠澳大橋,入境,78,11,10,99
4/6/2020,五+六,港珠澳大橋,出境,74,3,8,85
4/6/2020,五+六,落馬洲,入境,0,0,0,0
4/6/2020,五+六,落馬洲,出境,0,0,0,0
4/6/2020,五+六,文錦渡,入境,0,0,0,0
4/6/2020,五+六,文錦渡,出境,0,0,0,0
4/6/2020,五+六,沙頭角,入境,0,0,0,0
4/6/2020,五+六,沙頭角,出境,0,0,0,0
4/6/2020,五+六,深圳灣,入境,1365,205,9,1579
4/6/2020,五+六,深圳灣,出境,820,111,8,939
4/6/2020,五+六,中國客運碼頭,入境,0,0,0,0
4/6/2020,五+六,中國客運碼頭,出境,0,0,0,0
4/6/2020,五+六,港口管制,入境,0,0,0,0
4/6/2020,五+六,港口管制,出境,0,0,0,0
4/6/2020,五+六,啟德郵輪碼頭,入境,0,0,0,0
4/6/2020,五+六,啟德郵輪碼頭,出境,0,0,0,0
4/6/2020,五+六,港澳客輪碼頭,入境,0,0,0,0
4/6/2020,五+六,港澳客輪碼頭,出境,0,0,0,0
4/6/2020,五+六,屯門客運碼頭,入境,0,0,0,0
4/6/2020,五+六,屯門客運碼頭,出境,0,0,0,0
5/6/2020,五+六,機場,入境,1073,4,42,1119
5/6/2020,五+六,機場,出境,633,10,78,721
5/6/2020,五+六,高鐵西九龍,入境,0,0,0,0
5/6/2020,五+六,高鐵西九龍,出境,0,0,0,0
5/6/2020,五+六,紅磡,入境,0,0,0,0
5/6/2020,五+六,紅磡,出境,0,0,0,0
5/6/2020,五+六,羅湖,入境,0,0,0,0
5/6/2020,五+六,羅湖,出境,0,0,0,0
5/6/2020,五+六,落馬洲支線,入境,0,0,0,0
5/6/2020,五+六,落馬洲支線,出境,0,0,0,0
5/6/2020,五+六,港珠澳大橋,入境,124,7,9,140
5/6/2020,五+六,港珠澳大橋,出境,65,9,3,77
5/6/2020,五+六,落馬洲,入境,0,0,0,0
5/6/2020,五+六,落馬洲,出境,0,0,0,0
5/6/2020,五+六,文錦渡,入境,0,0,0,0
5/6/2020,五+六,文錦渡,出境,0,0,0,0
5/6/2020,五+六,沙頭角,入境,0,0,0,0
5/6/2020,五+六,沙頭角,出境,0,0,0,0
5/6/2020,五+六,深圳灣,入境,1378,223,13,1614
5/6/2020,五+六,深圳灣,出境,829,120,14,963
5/6/2020,五+六,中國客運碼頭,入境,0,0,0,0
5/6/2020,五+六,中國客運碼頭,出境,0,0,0,0
5/6/2020,五+六,港口管制,入境,0,0,0,0
5/6/2020,五+六,港口管制,出境,0,0,0,0
5/6/2020,五+六,啟德郵輪碼頭,入境,0,0,0,0
5/6/2020,五+六,啟德郵輪碼頭,出境,0,0,0,0
5/6/2020,五+六,港澳客輪碼頭,入境,0,0,0,0
5/6/2020,五+六,港澳客輪碼頭,出境,0,0,0,0
5/6/2020,五+六,屯門客運碼頭,入境,0,0,0,0
5/6/2020,五+六,屯門客運碼頭,出境,0,0,0,0
6/6/2020,五+六,機場,入境,527,7,46,580
6/6/2020,五+六,機場,出境,390,22,186,598
6/6/2020,五+六,高鐵西九龍,入境,0,0,0,0
6/6/2020,五+六,高鐵西九龍,出境,0,0,0,0
6/6/2020,五+六,紅磡,入境,0,0,0,0
6/6/2020,五+六,紅磡,出境,0,0,0,0
6/6/2020,五+六,羅湖,入境,0,0,0,0
6/6/2020,五+六,羅湖,出境,0,0,0,0
6/6/2020,五+六,落馬洲支線,入境,0,0,0,0
6/6/2020,五+六,落馬洲支線,出境,0,0,0,0
6/6/2020,五+六,港珠澳大橋,入境,115,14,4,133
6/6/2020,五+六,港珠澳大橋,出境,56,4,8,68
6/6/2020,五+六,落馬洲,入境,0,0,0,0
6/6/2020,五+六,落馬洲,出境,0,0,0,0
6/6/2020,五+六,文錦渡,入境,0,0,0,0
6/6/2020,五+六,文錦渡,出境,0,0,0,0
6/6/2020,五+六,沙頭角,入境,0,0,0,0
6/6/2020,五+六,沙頭角,出境,0,0,0,0
6/6/2020,五+六,深圳灣,入境,1368,262,14,1644
6/6/2020,五+六,深圳灣,出境,718,103,40,861
6/6/2020,五+六,中國客運碼頭,入境,0,0,0,0
6/6/2020,五+六,中國客運碼頭,出境,0,0,0,0
6/6/2020,五+六,港口管制,入境,0,0,0,0
6/6/2020,五+六,港口管制,出境,0,0,0,0
6/6/2020,五+六,啟德郵輪碼頭,入境,0,0,0,0
6/6/2020,五+六,啟德郵輪碼頭,出境,0,0,0,0
6/6/2020,五+六,港澳客輪碼頭,入境,0,0,0,0
6/6/2020,五+六,港澳客輪碼頭,出境,0,0,0,0
6/6/2020,五+六,屯門客運碼頭,入境,0,0,0,0
6/6/2020,五+六,屯門客運碼頭,出境,0,0,0,0
7/6/2020,五+六,機場,入境,1083,3,44,1130
7/6/2020,五+六,機場,出境,520,9,120,649
7/6/2020,五+六,高鐵西九龍,入境,0,0,0,0
7/6/2020,五+六,高鐵西九龍,出境,0,0,0,0
7/6/2020,五+六,紅磡,入境,0,0,0,0
7/6/2020,五+六,紅磡,出境,0,0,0,0
7/6/2020,五+六,羅湖,入境,0,0,0,0
7/6/2020,五+六,羅湖,出境,0,0,0,0
7/6/2020,五+六,落馬洲支線,入境,0,0,0,0
7/6/2020,五+六,落馬洲支線,出境,0,0,0,0
7/6/2020,五+六,港珠澳大橋,入境,122,7,11,140
7/6/2020,五+六,港珠澳大橋,出境,56,3,4,63
7/6/2020,五+六,落馬洲,入境,0,0,0,0
7/6/2020,五+六,落馬洲,出境,0,0,0,0
7/6/2020,五+六,文錦渡,入境,0,0,0,0
7/6/2020,五+六,文錦渡,出境,0,0,0,0
7/6/2020,五+六,沙頭角,入境,0,0,0,0
7/6/2020,五+六,沙頭角,出境,0,0,0,0
7/6/2020,五+六,深圳灣,入境,2123,366,16,2505
7/6/2020,五+六,深圳灣,出境,670,133,3,806
7/6/2020,五+六,中國客運碼頭,入境,0,0,0,0
7/6/2020,五+六,中國客運碼頭,出境,0,0,0,0
7/6/2020,五+六,港口管制,入境,0,0,0,0
7/6/2020,五+六,港口管制,出境,0,0,0,0
7/6/2020,五+六,啟德郵輪碼頭,入境,0,0,0,0
7/6/2020,五+六,啟德郵輪碼頭,出境,0,0,0,0
7/6/2020,五+六,港澳客輪碼頭,入境,0,0,0,0
7/6/2020,五+六,港澳客輪碼頭,出境,0,0,0,0
7/6/2020,五+六,屯門客運碼頭,入境,0,0,0,0
7/6/2020,五+六,屯門客運碼頭,出境,0,0,0,0
8/6/2020,五+六,機場,入境,786,14,102,902
8/6/2020,五+六,機場,出境,235,17,44,296
8/6/2020,五+六,高鐵西九龍,入境,0,0,0,0
8/6/2020,五+六,高鐵西九龍,出境,0,0,0,0
8/6/2020,五+六,紅磡,入境,0,0,0,0
8/6/2020,五+六,紅磡,出境,0,0,0,0
8/6/2020,五+六,羅湖,入境,0,0,0,0
8/6/2020,五+六,羅湖,出境,0,0,0,0
8/6/2020,五+六,落馬洲支線,入境,0,0,0,0
8/6/2020,五+六,落馬洲支線,出境,0,0,0,0
8/6/2020,五+六,港珠澳大橋,入境,152,11,10,173
8/6/2020,五+六,港珠澳大橋,出境,113,11,3,127
8/6/2020,五+六,落馬洲,入境,0,0,0,0
8/6/2020,五+六,落馬洲,出境,0,0,0,0
8/6/2020,五+六,文錦渡,入境,0,0,0,0
8/6/2020,五+六,文錦渡,出境,0,0,0,0
8/6/2020,五+六,沙頭角,入境,0,0,0,0
8/6/2020,五+六,沙頭角,出境,0,0,0,0
8/6/2020,五+六,深圳灣,入境,2081,287,22,2390
8/6/2020,五+六,深圳灣,出境,942,107,13,1062
8/6/2020,五+六,中國客運碼頭,入境,0,0,0,0
8/6/2020,五+六,中國客運碼頭,出境,0,0,0,0
8/6/2020,五+六,港口管制,入境,0,0,0,0
8/6/2020,五+六,港口管制,出境,0,0,0,0
8/6/2020,五+六,啟德郵輪碼頭,入境,0,0,0,0
8/6/2020,五+六,啟德郵輪碼頭,出境,0,0,0,0
8/6/2020,五+六,港澳客輪碼頭,入境,0,0,0,0
8/6/2020,五+六,港澳客輪碼頭,出境,0,0,0,0
8/6/2020,五+六,屯門客運碼頭,入境,0,0,0,0
8/6/2020,五+六,屯門客運碼頭,出境,0,0,0,0
9/6/2020,五+六,機場,入境,559,12,30,601
9/6/2020,五+六,機場,出境,374,22,44,440
9/6/2020,五+六,高鐵西九龍,入境,0,0,0,0
9/6/2020,五+六,高鐵西九龍,出境,0,0,0,0
9/6/2020,五+六,紅磡,入境,0,0,0,0
9/6/2020,五+六,紅磡,出境,0,0,0,0
9/6/2020,五+六,羅湖,入境,0,0,0,0
9/6/2020,五+六,羅湖,出境,0,0,0,0
9/6/2020,五+六,落馬洲支線,入境,0,0,0,0
9/6/2020,五+六,落馬洲支線,出境,0,0,0,0
9/6/2020,五+六,港珠澳大橋,入境,99,6,8,113
9/6/2020,五+六,港珠澳大橋,出境,64,7,4,75
9/6/2020,五+六,落馬洲,入境,0,0,0,0
9/6/2020,五+六,落馬洲,出境,0,0,0,0
9/6/2020,五+六,文錦渡,入境,0,0,0,0
9/6/2020,五+六,文錦渡,出境,0,0,0,0
9/6/2020,五+六,沙頭角,入境,0,0,0,0
9/6/2020,五+六,沙頭角,出境,0,0,0,0
9/6/2020,五+六,深圳灣,入境,1481,237,19,1737
9/6/2020,五+六,深圳灣,出境,764,133,5,902
9/6/2020,五+六,中國客運碼頭,入境,0,0,0,0
9/6/2020,五+六,中國客運碼頭,出境,0,0,0,0
9/6/2020,五+六,港口管制,入境,0,0,0,0
9/6/2020,五+六,港口管制,出境,0,0,0,0
9/6/2020,五+六,啟德郵輪碼頭,入境,0,0,0,0
9/6/2020,五+六,啟德郵輪碼頭,出境,0,0,0,0
9/6/2020,五+六,港澳客輪碼頭,入境,0,0,0,0
9/6/2020,五+六,港澳客輪碼頭,出境,0,0,0,0
9/6/2020,五+六,屯門客運碼頭,入境,0,0,0,0
9/6/2020,五+六,屯門客運碼頭,出境,0,0,0,0
10/6/2020,五+六,機場,入境,570,3,15,588
10/6/2020,五+六,機場,出境,330,15,199,544
10/6/2020,五+六,高鐵西九龍,入境,0,0,0,0
10/6/2020,五+六,高鐵西九龍,出境,0,0,0,0
10/6/2020,五+六,紅磡,入境,0,0,0,0
10/6/2020,五+六,紅磡,出境,0,0,0,0
10/6/2020,五+六,羅湖,入境,0,0,0,0
10/6/2020,五+六,羅湖,出境,0,0,0,0
10/6/2020,五+六,落馬洲支線,入境,0,0,0,0
10/6/2020,五+六,落馬洲支線,出境,0,0,0,0
10/6/2020,五+六,港珠澳大橋,入境,114,12,13,139
10/6/2020,五+六,港珠澳大橋,出境,61,3,1,65
10/6/2020,五+六,落馬洲,入境,0,0,0,0
10/6/2020,五+六,落馬洲,出境,0,0,0,0
10/6/2020,五+六,文錦渡,入境,0,0,0,0
10/6/2020,五+六,文錦渡,出境,0,0,0,0
10/6/2020,五+六,沙頭角,入境,0,0,0,0
10/6/2020,五+六,沙頭角,出境,0,0,0,0
10/6/2020,五+六,深圳灣,入境,1520,251,18,1789
10/6/2020,五+六,深圳灣,出境,714,106,4,824
10/6/2020,五+六,中國客運碼頭,入境,0,0,0,0
10/6/2020,五+六,中國客運碼頭,出境,0,0,0,0
10/6/2020,五+六,港口管制,入境,0,0,0,0
10/6/2020,五+六,港口管制,出境,0,0,0,0
10/6/2020,五+六,啟德郵輪碼頭,入境,0,0,0,0
10/6/2020,五+六,啟德郵輪碼頭,出境,0,0,0,0
10/6/2020,五+六,港澳客輪碼頭,入境,0,0,0,0
10/6/2020,五+六,港澳客輪碼頭,出境,0,0,0,0
10/6/2020,五+六,屯門客運碼頭,入境,0,0,0,0
10/6/2020,五+六,屯門客運碼頭,出境,0,0,0,0
11/6/2020,五+六,機場,入境,626,4,19,649
11/6/2020,五+六,機場,出境,341,10,36,387
11/6/2020,五+六,高鐵西九龍,入境,0,0,0,0
11/6/2020,五+六,高鐵西九龍,出境,0,0,0,0
11/6/2020,五+六,紅磡,入境,0,0,0,0
11/6/2020,五+六,紅磡,出境,0,0,0,0
11/6/2020,五+六,羅湖,入境,0,0,0,0
11/6/2020,五+六,羅湖,出境,0,0,0,0
11/6/2020,五+六,落馬洲支線,入境,0,0,0,0
11/6/2020,五+六,落馬洲支線,出境,0,0,0,0
11/6/2020,五+六,港珠澳大橋,入境,83,7,5,95
11/6/2020,五+六,港珠澳大橋,出境,61,3,3,67
11/6/2020,五+六,落馬洲,入境,0,0,0,0
11/6/2020,五+六,落馬洲,出境,0,0,0,0
11/6/2020,五+六,文錦渡,入境,0,0,0,0
11/6/2020,五+六,文錦渡,出境,0,0,0,0
11/6/2020,五+六,沙頭角,入境,0,0,0,0
11/6/2020,五+六,沙頭角,出境,0,0,0,0
11/6/2020,五+六,深圳灣,入境,1018,175,8,1201
11/6/2020,五+六,深圳灣,出境,483,61,8,552
11/6/2020,五+六,中國客運碼頭,入境,0,0,0,0
11/6/2020,五+六,中國客運碼頭,出境,0,0,0,0
11/6/2020,五+六,港口管制,入境,0,0,0,0
11/6/2020,五+六,港口管制,出境,0,0,0,0
11/6/2020,五+六,啟德郵輪碼頭,入境,0,0,0,0
11/6/2020,五+六,啟德郵輪碼頭,出境,0,0,0,0
11/6/2020,五+六,港澳客輪碼頭,入境,0,0,0,0
11/6/2020,五+六,港澳客輪碼頭,出境,0,0,0,0
11/6/2020,五+六,屯門客運碼頭,入境,0,0,0,0
11/6/2020,五+六,屯門客運碼頭,出境,0,0,0,0
12/6/2020,五+六,機場,入境,1082,7,72,1161
12/6/2020,五+六,機場,出境,482,5,92,579
12/6/2020,五+六,高鐵西九龍,入境,0,0,0,0
12/6/2020,五+六,高鐵西九龍,出境,0,0,0,0
12/6/2020,五+六,紅磡,入境,0,0,0,0
12/6/2020,五+六,紅磡,出境,0,0,0,0
12/6/2020,五+六,羅湖,入境,0,0,0,0
12/6/2020,五+六,羅湖,出境,0,0,0,0
12/6/2020,五+六,落馬洲支線,入境,0,0,0,0
12/6/2020,五+六,落馬洲支線,出境,0,0,0,0
12/6/2020,五+六,港珠澳大橋,入境,68,9,31,108
12/6/2020,五+六,港珠澳大橋,出境,48,2,4,54
12/6/2020,五+六,落馬洲,入境,0,0,0,0
12/6/2020,五+六,落馬洲,出境,0,0,0,0
12/6/2020,五+六,文錦渡,入境,0,0,0,0
12/6/2020,五+六,文錦渡,出境,0,0,0,0
12/6/2020,五+六,沙頭角,入境,0,0,0,0
12/6/2020,五+六,沙頭角,出境,0,0,0,0
12/6/2020,五+六,深圳灣,入境,924,166,19,1109
12/6/2020,五+六,深圳灣,出境,451,63,6,520
12/6/2020,五+六,中國客運碼頭,入境,0,0,0,0
12/6/2020,五+六,中國客運碼頭,出境,0,0,0,0
12/6/2020,五+六,港口管制,入境,0,0,0,0
12/6/2020,五+六,港口管制,出境,0,0,0,0
12/6/2020,五+六,啟德郵輪碼頭,入境,0,0,0,0
12/6/2020,五+六,啟德郵輪碼頭,出境,0,0,0,0
12/6/2020,五+六,港澳客輪碼頭,入境,0,0,0,0
12/6/2020,五+六,港澳客輪碼頭,出境,0,0,0,0
12/6/2020,五+六,屯門客運碼頭,入境,0,0,0,0
12/6/2020,五+六,屯門客運碼頭,出境,0,0,0,0
13/6/2020,五+六,機場,入境,732,4,54,790
13/6/2020,五+六,機場,出境,331,14,62,407
13/6/2020,五+六,高鐵西九龍,入境,0,0,0,0
13/6/2020,五+六,高鐵西九龍,出境,0,0,0,0
13/6/2020,五+六,紅磡,入境,0,0,0,0
13/6/2020,五+六,紅磡,出境,0,0,0,0
13/6/2020,五+六,羅湖,入境,0,0,0,0
13/6/2020,五+六,羅湖,出境,0,0,0,0
13/6/2020,五+六,落馬洲支線,入境,0,0,0,0
13/6/2020,五+六,落馬洲支線,出境,0,0,0,0
13/6/2020,五+六,港珠澳大橋,入境,87,7,4,98
13/6/2020,五+六,港珠澳大橋,出境,50,3,4,57
13/6/2020,五+六,落馬洲,入境,0,0,0,0
13/6/2020,五+六,落馬洲,出境,0,0,0,0
13/6/2020,五+六,文錦渡,入境,0,0,0,0
13/6/2020,五+六,文錦渡,出境,0,0,0,0
13/6/2020,五+六,沙頭角,入境,0,0,0,0
13/6/2020,五+六,沙頭角,出境,0,0,0,0
13/6/2020,五+六,深圳灣,入境,863,225,19,1107
13/6/2020,五+六,深圳灣,出境,398,65,7,470
13/6/2020,五+六,中國客運碼頭,入境,0,0,0,0
13/6/2020,五+六,中國客運碼頭,出境,0,0,0,0
13/6/2020,五+六,港口管制,入境,0,0,0,0
13/6/2020,五+六,港口管制,出境,0,0,0,0
13/6/2020,五+六,啟德郵輪碼頭,入境,0,0,0,0
13/6/2020,五+六,啟德郵輪碼頭,出境,0,0,0,0
13/6/2020,五+六,港澳客輪碼頭,入境,0,0,0,0
13/6/2020,五+六,港澳客輪碼頭,出境,0,0,0,0
13/6/2020,五+六,屯門客運碼頭,入境,0,0,0,0
13/6/2020,五+六,屯門客運碼頭,出境,0,0,0,0
14/6/2020,五+六,機場,入境,970,3,50,1023
14/6/2020,五+六,機場,出境,550,16,80,646
14/6/2020,五+六,高鐵西九龍,入境,0,0,0,0
14/6/2020,五+六,高鐵西九龍,出境,0,0,0,0
14/6/2020,五+六,紅磡,入境,0,0,0,0
14/6/2020,五+六,紅磡,出境,0,0,0,0
14/6/2020,五+六,羅湖,入境,0,0,0,0
14/6/2020,五+六,羅湖,出境,0,0,0,0
14/6/2020,五+六,落馬洲支線,入境,0,0,0,0
14/6/2020,五+六,落馬洲支線,出境,0,0,0,0
14/6/2020,五+六,港珠澳大橋,入境,30,4,3,37
14/6/2020,五+六,港珠澳大橋,出境,28,3,6,37
14/6/2020,五+六,落馬洲,入境,0,0,0,0
14/6/2020,五+六,落馬洲,出境,0,0,0,0
14/6/2020,五+六,文錦渡,入境,0,0,0,0
14/6/2020,五+六,文錦渡,出境,0,0,0,0
14/6/2020,五+六,沙頭角,入境,0,0,0,0
14/6/2020,五+六,沙頭角,出境,0,0,0,0
14/6/2020,五+六,深圳灣,入境,651,149,14,814
14/6/2020,五+六,深圳灣,出境,298,79,6,383
14/6/2020,五+六,中國客運碼頭,入境,0,0,0,0
14/6/2020,五+六,中國客運碼頭,出境,0,0,0,0
14/6/2020,五+六,港口管制,入境,0,0,0,0
14/6/2020,五+六,港口管制,出境,0,0,0,0
14/6/2020,五+六,啟德郵輪碼頭,入境,0,0,0,0
14/6/2020,五+六,啟德郵輪碼頭,出境,0,0,0,0
14/6/2020,五+六,港澳客輪碼頭,入境,0,0,0,0
14/6/2020,五+六,港澳客輪碼頭,出境,0,0,0,0
14/6/2020,五+六,屯門客運碼頭,入境,0,0,0,0
14/6/2020,五+六,屯門客運碼頭,出境,0,0,0,0
15/6/2020,五+六,機場,入境,877,7,75,959
15/6/2020,五+六,機場,出境,280,12,58,350
15/6/2020,五+六,高鐵西九龍,入境,0,0,0,0
15/6/2020,五+六,高鐵西九龍,出境,0,0,0,0
15/6/2020,五+六,紅磡,入境,0,0,0,0
15/6/2020,五+六,紅磡,出境,0,0,0,0
15/6/2020,五+六,羅湖,入境,0,0,0,0
15/6/2020,五+六,羅湖,出境,0,0,0,0
15/6/2020,五+六,落馬洲支線,入境,1297,0,0,1297
15/6/2020,五+六,落馬洲支線,出境,1297,0,0,1297
15/6/2020,五+六,港珠澳大橋,入境,51,3,3,57
15/6/2020,五+六,港珠澳大橋,出境,63,1,5,69
15/6/2020,五+六,落馬洲,入境,0,0,0,0
15/6/2020,五+六,落馬洲,出境,0,0,0,0
15/6/2020,五+六,文錦渡,入境,0,0,0,0
15/6/2020,五+六,文錦渡,出境,0,0,0,0
15/6/2020,五+六,沙頭角,入境,0,0,0,0
15/6/2020,五+六,沙頭角,出境,0,0,0,0
15/6/2020,五+六,深圳灣,入境,1259,160,18,1437
15/6/2020,五+六,深圳灣,出境,858,74,23,955
15/6/2020,五+六,中國客運碼頭,入境,0,0,0,0
15/6/2020,五+六,中國客運碼頭,出境,0,0,0,0
15/6/2020,五+六,港口管制,入境,0,0,0,0
15/6/2020,五+六,港口管制,出境,0,0,0,0
15/6/2020,五+六,啟德郵輪碼頭,入境,0,0,0,0
15/6/2020,五+六,啟德郵輪碼頭,出境,0,0,0,0
15/6/2020,五+六,港澳客輪碼頭,入境,0,0,0,0
15/6/2020,五+六,港澳客輪碼頭,出境,0,0,0,0
15/6/2020,五+六,屯門客運碼頭,入境,0,0,0,0
15/6/2020,五+六,屯門客運碼頭,出境,0,0,0,0
16/6/2020,五+六,機場,入境,928,4,42,974
16/6/2020,五+六,機場,出境,477,19,51,547
16/6/2020,五+六,高鐵西九龍,入境,0,0,0,0
16/6/2020,五+六,高鐵西九龍,出境,0,0,0,0
16/6/2020,五+六,紅磡,入境,0,0,0,0
16/6/2020,五+六,紅磡,出境,0,0,0,0
16/6/2020,五+六,羅湖,入境,0,0,0,0
16/6/2020,五+六,羅湖,出境,0,0,0,0
16/6/2020,五+六,落馬洲支線,入境,1249,0,0,1249
16/6/2020,五+六,落馬洲支線,出境,1249,0,0,1249
16/6/2020,五+六,港珠澳大橋,入境,55,1,9,65
16/6/2020,五+六,港珠澳大橋,出境,82,4,11,97
16/6/2020,五+六,落馬洲,入境,0,0,0,0
16/6/2020,五+六,落馬洲,出境,0,0,0,0
16/6/2020,五+六,文錦渡,入境,0,0,0,0
16/6/2020,五+六,文錦渡,出境,0,0,0,0
16/6/2020,五+六,沙頭角,入境,0,0,0,0
16/6/2020,五+六,沙頭角,出境,0,0,0,0
16/6/2020,五+六,深圳灣,入境,1127,159,15,1301
16/6/2020,五+六,深圳灣,出境,796,77,3,876
16/6/2020,五+六,中國客運碼頭,入境,0,0,0,0
16/6/2020,五+六,中國客運碼頭,出境,0,0,0,0
16/6/2020,五+六,港口管制,入境,0,0,0,0
16/6/2020,五+六,港口管制,出境,0,0,0,0
16/6/2020,五+六,啟德郵輪碼頭,入境,0,0,0,0
16/6/2020,五+六,啟德郵輪碼頭,出境,0,0,0,0
16/6/2020,五+六,港澳客輪碼頭,入境,0,0,0,0
16/6/2020,五+六,港澳客輪碼頭,出境,0,0,0,0
16/6/2020,五+六,屯門客運碼頭,入境,0,0,0,0
16/6/2020,五+六,屯門客運碼頭,出境,0,0,0,0
17/6/2020,五+六,機場,入境,846,11,40,897
17/6/2020,五+六,機場,出境,243,8,35,286
17/6/2020,五+六,高鐵西九龍,入境,0,0,0,0
17/6/2020,五+六,高鐵西九龍,出境,0,0,0,0
17/6/2020,五+六,紅磡,入境,0,0,0,0
17/6/2020,五+六,紅磡,出境,0,0,0,0
17/6/2020,五+六,羅湖,入境,0,0,0,0
17/6/2020,五+六,羅湖,出境,0,0,0,0
17/6/2020,五+六,落馬洲支線,入境,1272,0,0,1272
17/6/2020,五+六,落馬洲支線,出境,1272,0,0,1272
17/6/2020,五+六,港珠澳大橋,入境,71,0,12,83
17/6/2020,五+六,港珠澳大橋,出境,75,6,1,82
17/6/2020,五+六,落馬洲,入境,0,0,0,0
17/6/2020,五+六,落馬洲,出境,0,0,0,0
17/6/2020,五+六,文錦渡,入境,0,0,0,0
17/6/2020,五+六,文錦渡,出境,0,0,0,0
17/6/2020,五+六,沙頭角,入境,0,0,0,0
17/6/2020,五+六,沙頭角,出境,0,0,0,0
17/6/2020,五+六,深圳灣,入境,1074,137,17,1228
17/6/2020,五+六,深圳灣,出境,796,112,2,910
17/6/2020,五+六,中國客運碼頭,入境,0,0,0,0
17/6/2020,五+六,中國客運碼頭,出境,0,0,0,0
17/6/2020,五+六,港口管制,入境,0,0,0,0
17/6/2020,五+六,港口管制,出境,0,0,0,0
17/6/2020,五+六,啟德郵輪碼頭,入境,0,0,0,0
17/6/2020,五+六,啟德郵輪碼頭,出境,0,0,0,0
17/6/2020,五+六,港澳客輪碼頭,入境,0,0,0,0
17/6/2020,五+六,港澳客輪碼頭,出境,0,0,0,0
17/6/2020,五+六,屯門客運碼頭,入境,0,0,0,0
17/6/2020,五+六,屯門客運碼頭,出境,0,0,0,0
18/6/2020,五+六,機場,入境,708,0,34,742
18/6/2020,五+六,機場,出境,438,6,95,539
18/6/2020,五+六,高鐵西九龍,入境,0,0,0,0
18/6/2020,五+六,高鐵西九龍,出境,0,0,0,0
18/6/2020,五+六,紅磡,入境,0,0,0,0
18/6/2020,五+六,紅磡,出境,0,0,0,0
18/6/2020,五+六,羅湖,入境,0,0,0,0
18/6/2020,五+六,羅湖,出境,0,0,0,0
18/6/2020,五+六,落馬洲支線,入境,1271,0,0,1271
18/6/2020,五+六,落馬洲支線,出境,1271,0,0,1271
18/6/2020,五+六,港珠澳大橋,入境,56,3,4,63
18/6/2020,五+六,港珠澳大橋,出境,60,8,3,71
18/6/2020,五+六,落馬洲,入境,0,0,0,0
18/6/2020,五+六,落馬洲,出境,0,0,0,0
18/6/2020,五+六,文錦渡,入境,0,0,0,0
18/6/2020,五+六,文錦渡,出境,0,0,0,0
18/6/2020,五+六,沙頭角,入境,0,0,0,0
18/6/2020,五+六,沙頭角,出境,0,0,0,0
18/6/2020,五+六,深圳灣,入境,1026,143,19,1188
18/6/2020,五+六,深圳灣,出境,845,92,1,938
18/6/2020,五+六,中國客運碼頭,入境,0,0,0,0
18/6/2020,五+六,中國客運碼頭,出境,0,0,0,0
18/6/2020,五+六,港口管制,入境,0,0,0,0
18/6/2020,五+六,港口管制,出境,0,0,0,0
18/6/2020,五+六,啟德郵輪碼頭,入境,0,0,0,0
18/6/2020,五+六,啟德郵輪碼頭,出境,0,0,0,0
18/6/2020,五+六,港澳客輪碼頭,入境,0,0,0,0
18/6/2020,五+六,港澳客輪碼頭,出境,0,0,0,0
18/6/2020,五+六,屯門客運碼頭,入境,0,0,0,0
18/6/2020,五+六,屯門客運碼頭,出境,0,0,0,0
19/6/2020,五+六,機場,入境,1022,2,86,1110
19/6/2020,五+六,機場,出境,641,5,180,826
19/6/2020,五+六,高鐵西九龍,入境,0,0,0,0
19/6/2020,五+六,高鐵西九龍,出境,0,0,0,0
19/6/2020,五+六,紅磡,入境,0,0,0,0
19/6/2020,五+六,紅磡,出境,0,0,0,0
19/6/2020,五+六,羅湖,入境,0,0,0,0
19/6/2020,五+六,羅湖,出境,0,0,0,0
19/6/2020,五+六,落馬洲支線,入境,1147,0,0,1147
19/6/2020,五+六,落馬洲支線,出境,1146,0,0,1146
19/6/2020,五+六,港珠澳大橋,入境,59,8,3,70
19/6/2020,五+六,港珠澳大橋,出境,71,1,8,80
19/6/2020,五+六,落馬洲,入境,0,0,0,0
19/6/2020,五+六,落馬洲,出境,0,0,0,0
19/6/2020,五+六,文錦渡,入境,0,0,0,0
19/6/2020,五+六,文錦渡,出境,0,0,0,0
19/6/2020,五+六,沙頭角,入境,0,0,0,0
19/6/2020,五+六,沙頭角,出境,0,0,0,0
19/6/2020,五+六,深圳灣,入境,1000,110,10,1120
19/6/2020,五+六,深圳灣,出境,741,75,13,829
19/6/2020,五+六,中國客運碼頭,入境,0,0,0,0
19/6/2020,五+六,中國客運碼頭,出境,0,0,0,0
19/6/2020,五+六,港口管制,入境,0,0,0,0
19/6/2020,五+六,港口管制,出境,0,0,0,0
19/6/2020,五+六,啟德郵輪碼頭,入境,0,0,0,0
19/6/2020,五+六,啟德郵輪碼頭,出境,0,0,0,0
19/6/2020,五+六,港澳客輪碼頭,入境,0,0,0,0
19/6/2020,五+六,港澳客輪碼頭,出境,0,0,0,0
19/6/2020,五+六,屯門客運碼頭,入境,0,0,0,0
19/6/2020,五+六,屯門客運碼頭,出境,0,0,0,0
20/6/2020,五+六,機場,入境,972,12,54,1038
20/6/2020,五+六,機場,出境,392,5,51,448
20/6/2020,五+六,高鐵西九龍,入境,0,0,0,0
20/6/2020,五+六,高鐵西九龍,出境,0,0,0,0
20/6/2020,五+六,紅磡,入境,0,0,0,0
20/6/2020,五+六,紅磡,出境,0,0,0,0
20/6/2020,五+六,羅湖,入境,0,0,0,0
20/6/2020,五+六,羅湖,出境,0,0,0,0
20/6/2020,五+六,落馬洲支線,入境,0,0,0,0
20/6/2020,五+六,落馬洲支線,出境,0,0,0,0
20/6/2020,五+六,港珠澳大橋,入境,46,5,8,59
20/6/2020,五+六,港珠澳大橋,出境,54,4,6,64
20/6/2020,五+六,落馬洲,入境,0,0,0,0
20/6/2020,五+六,落馬洲,出境,0,0,0,0
20/6/2020,五+六,文錦渡,入境,0,0,0,0
20/6/2020,五+六,文錦渡,出境,0,0,0,0
20/6/2020,五+六,沙頭角,入境,0,0,0,0
20/6/2020,五+六,沙頭角,出境,0,0,0,0
20/6/2020,五+六,深圳灣,入境,728,154,21,903
20/6/2020,五+六,深圳灣,出境,444,85,5,534
20/6/2020,五+六,中國客運碼頭,入境,0,0,0,0
20/6/2020,五+六,中國客運碼頭,出境,0,0,0,0
20/6/2020,五+六,港口管制,入境,0,0,0,0
20/6/2020,五+六,港口管制,出境,0,0,0,0
20/6/2020,五+六,啟德郵輪碼頭,入境,0,0,0,0
20/6/2020,五+六,啟德郵輪碼頭,出境,0,0,0,0
20/6/2020,五+六,港澳客輪碼頭,入境,0,0,0,0
20/6/2020,五+六,港澳客輪碼頭,出境,0,0,0,0
20/6/2020,五+六,屯門客運碼頭,入境,0,0,0,0
20/6/2020,五+六,屯門客運碼頭,出境,0,0,0,0
21/6/2020,五+六,機場,入境,1385,5,71,1461
21/6/2020,五+六,機場,出境,742,27,78,847
21/6/2020,五+六,高鐵西九龍,入境,0,0,0,0
21/6/2020,五+六,高鐵西九龍,出境,0,0,0,0
21/6/2020,五+六,紅磡,入境,0,0,0,0
21/6/2020,五+六,紅磡,出境,0,0,0,0
21/6/2020,五+六,羅湖,入境,0,0,0,0
21/6/2020,五+六,羅湖,出境,0,0,0,0
21/6/2020,五+六,落馬洲支線,入境,0,0,0,0
21/6/2020,五+六,落馬洲支線,出境,0,0,0,0
21/6/2020,五+六,港珠澳大橋,入境,52,0,1,53
21/6/2020,五+六,港珠澳大橋,出境,38,3,2,43
21/6/2020,五+六,落馬洲,入境,0,0,0,0
21/6/2020,五+六,落馬洲,出境,0,0,0,0
21/6/2020,五+六,文錦渡,入境,0,0,0,0
21/6/2020,五+六,文錦渡,出境,0,0,0,0
21/6/2020,五+六,沙頭角,入境,0,0,0,0
21/6/2020,五+六,沙頭角,出境,0,0,0,0
21/6/2020,五+六,深圳灣,入境,623,141,17,781
21/6/2020,五+六,深圳灣,出境,399,77,5,481
21/6/2020,五+六,中國客運碼頭,入境,0,0,0,0
21/6/2020,五+六,中國客運碼頭,出境,0,0,0,0
21/6/2020,五+六,港口管制,入境,0,0,0,0
21/6/2020,五+六,港口管制,出境,0,0,0,0
21/6/2020,五+六,啟德郵輪碼頭,入境,0,0,0,0
21/6/2020,五+六,啟德郵輪碼頭,出境,0,0,0,0
21/6/2020,五+六,港澳客輪碼頭,入境,0,0,0,0
21/6/2020,五+六,港澳客輪碼頭,出境,0,0,0,0
21/6/2020,五+六,屯門客運碼頭,入境,0,0,0,0
21/6/2020,五+六,屯門客運碼頭,出境,0,0,0,0
22/6/2020,五+六,機場,入境,592,7,64,663
22/6/2020,五+六,機場,出境,211,4,36,251
22/6/2020,五+六,高鐵西九龍,入境,0,0,0,0
22/6/2020,五+六,高鐵西九龍,出境,0,0,0,0
22/6/2020,五+六,紅磡,入境,0,0,0,0
22/6/2020,五+六,紅磡,出境,0,0,0,0
22/6/2020,五+六,羅湖,入境,0,0,0,0
22/6/2020,五+六,羅湖,出境,0,0,0,0
22/6/2020,五+六,落馬洲支線,入境,1285,0,0,1285
22/6/2020,五+六,落馬洲支線,出境,1285,0,0,1285
22/6/2020,五+六,港珠澳大橋,入境,54,4,2,60
22/6/2020,五+六,港珠澳大橋,出境,86,5,14,105
22/6/2020,五+六,落馬洲,入境,0,0,0,0
22/6/2020,五+六,落馬洲,出境,0,0,0,0
22/6/2020,五+六,文錦渡,入境,0,0,0,0
22/6/2020,五+六,文錦渡,出境,0,0,0,0
22/6/2020,五+六,沙頭角,入境,0,0,0,0
22/6/2020,五+六,沙頭角,出境,0,0,0,0
22/6/2020,五+六,深圳灣,入境,1048,168,18,1234
22/6/2020,五+六,深圳灣,出境,998,74,31,1103
22/6/2020,五+六,中國客運碼頭,入境,0,0,0,0
22/6/2020,五+六,中國客運碼頭,出境,0,0,0,0
22/6/2020,五+六,港口管制,入境,0,0,0,0
22/6/2020,五+六,港口管制,出境,0,0,0,0
22/6/2020,五+六,啟德郵輪碼頭,入境,0,0,0,0
22/6/2020,五+六,啟德郵輪碼頭,出境,0,0,0,0
22/6/2020,五+六,港澳客輪碼頭,入境,0,0,0,0
22/6/2020,五+六,港澳客輪碼頭,出境,0,0,0,0
22/6/2020,五+六,屯門客運碼頭,入境,0,0,0,0
22/6/2020,五+六,屯門客運碼頭,出境,0,0,0,0
23/6/2020,五+六,機場,入境,1179,9,34,1222
23/6/2020,五+六,機場,出境,429,18,54,501
23/6/2020,五+六,高鐵西九龍,入境,0,0,0,0
23/6/2020,五+六,高鐵西九龍,出境,0,0,0,0
23/6/2020,五+六,紅磡,入境,0,0,0,0
23/6/2020,五+六,紅磡,出境,0,0,0,0
23/6/2020,五+六,羅湖,入境,0,0,0,0
23/6/2020,五+六,羅湖,出境,0,0,0,0
23/6/2020,五+六,落馬洲支線,入境,1299,0,0,1299
23/6/2020,五+六,落馬洲支線,出境,1299,0,0,1299
23/6/2020,五+六,港珠澳大橋,入境,48,2,3,53
23/6/2020,五+六,港珠澳大橋,出境,58,3,4,65
23/6/2020,五+六,落馬洲,入境,0,0,0,0
23/6/2020,五+六,落馬洲,出境,0,0,0,0
23/6/2020,五+六,文錦渡,入境,0,0,0,0
23/6/2020,五+六,文錦渡,出境,0,0,0,0
23/6/2020,五+六,沙頭角,入境,0,0,0,0
23/6/2020,五+六,沙頭角,出境,0,0,0,0
23/6/2020,五+六,深圳灣,入境,973,136,9,1118
23/6/2020,五+六,深圳灣,出境,778,73,6,857
23/6/2020,五+六,中國客運碼頭,入境,0,0,0,0
23/6/2020,五+六,中國客運碼頭,出境,0,0,0,0
23/6/2020,五+六,港口管制,入境,0,0,0,0
23/6/2020,五+六,港口管制,出境,0,0,0,0
23/6/2020,五+六,啟德郵輪碼頭,入境,0,0,0,0
23/6/2020,五+六,啟德郵輪碼頭,出境,0,0,0,0
23/6/2020,五+六,港澳客輪碼頭,入境,0,0,0,0
23/6/2020,五+六,港澳客輪碼頭,出境,0,0,0,0
23/6/2020,五+六,屯門客運碼頭,入境,0,0,0,0
23/6/2020,五+六,屯門客運碼頭,出境,0,0,0,0
24/6/2020,五+六,機場,入境,738,3,55,796
24/6/2020,五+六,機場,出境,547,6,44,597
24/6/2020,五+六,高鐵西九龍,入境,0,0,0,0
24/6/2020,五+六,高鐵西九龍,出境,0,0,0,0
24/6/2020,五+六,紅磡,入境,0,0,0,0
24/6/2020,五+六,紅磡,出境,0,0,0,0
24/6/2020,五+六,羅湖,入境,0,0,0,0
24/6/2020,五+六,羅湖,出境,0,0,0,0
24/6/2020,五+六,落馬洲支線,入境,1292,0,0,1292
24/6/2020,五+六,落馬洲支線,出境,1293,0,0,1293
24/6/2020,五+六,港珠澳大橋,入境,52,2,3,57
24/6/2020,五+六,港珠澳大橋,出境,67,5,4,76
24/6/2020,五+六,落馬洲,入境,0,0,0,0
24/6/2020,五+六,落馬洲,出境,0,0,0,0
24/6/2020,五+六,文錦渡,入境,0,0,0,0
24/6/2020,五+六,文錦渡,出境,0,0,0,0
24/6/2020,五+六,沙頭角,入境,0,0,0,0
24/6/2020,五+六,沙頭角,出境,0,0,0,0
24/6/2020,五+六,深圳灣,入境,1019,99,15,1133
24/6/2020,五+六,深圳灣,出境,796,72,4,872
24/6/2020,五+六,中國客運碼頭,入境,0,0,0,0
24/6/2020,五+六,中國客運碼頭,出境,0,0,0,0
24/6/2020,五+六,港口管制,入境,0,0,0,0
24/6/2020,五+六,港口管制,出境,0,0,0,0
24/6/2020,五+六,啟德郵輪碼頭,入境,0,0,0,0
24/6/2020,五+六,啟德郵輪碼頭,出境,0,0,0,0
24/6/2020,五+六,港澳客輪碼頭,入境,0,0,0,0
24/6/2020,五+六,港澳客輪碼頭,出境,0,0,0,0
24/6/2020,五+六,屯門客運碼頭,入境,0,0,0,0
24/6/2020,五+六,屯門客運碼頭,出境,0,0,0,0
25/6/2020,七,機場,入境,815,2,46,863
25/6/2020,七,機場,出境,716,11,68,795
25/6/2020,七,高鐵西九龍,入境,0,0,0,0
25/6/2020,七,高鐵西九龍,出境,0,0,0,0
25/6/2020,七,紅磡,入境,0,0,0,0
25/6/2020,七,紅磡,出境,0,0,0,0
25/6/2020,七,羅湖,入境,0,0,0,0
25/6/2020,七,羅湖,出境,0,0,0,0
25/6/2020,七,落馬洲支線,入境,0,0,0,0
25/6/2020,七,落馬洲支線,出境,0,0,0,0
25/6/2020,七,港珠澳大橋,入境,49,2,1,52
25/6/2020,七,港珠澳大橋,出境,57,3,3,63
25/6/2020,七,落馬洲,入境,0,0,0,0
25/6/2020,七,落馬洲,出境,0,0,0,0
25/6/2020,七,文錦渡,入境,0,0,0,0
25/6/2020,七,文錦渡,出境,0,0,0,0
25/6/2020,七,沙頭角,入境,0,0,0,0
25/6/2020,七,沙頭角,出境,0,0,0,0
25/6/2020,七,深圳灣,入境,501,93,9,603
25/6/2020,七,深圳灣,出境,383,56,0,439
25/6/2020,七,中國客運碼頭,入境,0,0,0,0
25/6/2020,七,中國客運碼頭,出境,0,0,0,0
25/6/2020,七,港口管制,入境,0,0,0,0
25/6/2020,七,港口管制,出境,0,0,0,0
25/6/2020,七,啟德郵輪碼頭,入境,0,0,0,0
25/6/2020,七,啟德郵輪碼頭,出境,0,0,0,0
25/6/2020,七,港澳客輪碼頭,入境,0,0,0,0
25/6/2020,七,港澳客輪碼頭,出境,0,0,0,0
25/6/2020,七,屯門客運碼頭,入境,0,0,0,0
25/6/2020,七,屯門客運碼頭,出境,0,0,0,0
26/6/2020,七,機場,入境,1077,8,57,1142
26/6/2020,七,機場,出境,640,13,85,738
26/6/2020,七,高鐵西九龍,入境,0,0,0,0
26/6/2020,七,高鐵西九龍,出境,0,0,0,0
26/6/2020,七,紅磡,入境,0,0,0,0
26/6/2020,七,紅磡,出境,0,0,0,0
26/6/2020,七,羅湖,入境,0,0,0,0
26/6/2020,七,羅湖,出境,0,0,0,0
26/6/2020,七,落馬洲支線,入境,1264,0,0,1264
26/6/2020,七,落馬洲支線,出境,1264,0,0,1264
26/6/2020,七,港珠澳大橋,入境,40,3,6,49
26/6/2020,七,港珠澳大橋,出境,58,7,2,67
26/6/2020,七,落馬洲,入境,0,0,0,0
26/6/2020,七,落馬洲,出境,0,0,0,0
26/6/2020,七,文錦渡,入境,0,0,0,0
26/6/2020,七,文錦渡,出境,0,0,0,0
26/6/2020,七,沙頭角,入境,0,0,0,0
26/6/2020,七,沙頭角,出境,0,0,0,0
26/6/2020,七,深圳灣,入境,813,99,17,929
26/6/2020,七,深圳灣,出境,732,76,2,810
26/6/2020,七,中國客運碼頭,入境,0,0,0,0
26/6/2020,七,中國客運碼頭,出境,0,0,0,0
26/6/2020,七,港口管制,入境,0,0,0,0
26/6/2020,七,港口管制,出境,0,0,0,0
26/6/2020,七,啟德郵輪碼頭,入境,0,0,0,0
26/6/2020,七,啟德郵輪碼頭,出境,0,0,0,0
26/6/2020,七,港澳客輪碼頭,入境,0,0,0,0
26/6/2020,七,港澳客輪碼頭,出境,0,0,0,0
26/6/2020,七,屯門客運碼頭,入境,0,0,0,0
26/6/2020,七,屯門客運碼頭,出境,0,0,0,0
27/6/2020,七,機場,入境,1024,1,53,1078
27/6/2020,七,機場,出境,625,15,138,778
27/6/2020,七,高鐵西九龍,入境,0,0,0,0
27/6/2020,七,高鐵西九龍,出境,0,0,0,0
27/6/2020,七,紅磡,入境,0,0,0,0
27/6/2020,七,紅磡,出境,0,0,0,0
27/6/2020,七,羅湖,入境,0,0,0,0
27/6/2020,七,羅湖,出境,0,0,0,0
27/6/2020,七,落馬洲支線,入境,0,0,0,0
27/6/2020,七,落馬洲支線,出境,0,0,0,0
27/6/2020,七,港珠澳大橋,入境,37,7,10,54
27/6/2020,七,港珠澳大橋,出境,42,2,3,47
27/6/2020,七,落馬洲,入境,0,0,0,0
27/6/2020,七,落馬洲,出境,0,0,0,0
27/6/2020,七,文錦渡,入境,0,0,0,0
27/6/2020,七,文錦渡,出境,0,0,0,0
27/6/2020,七,沙頭角,入境,0,0,0,0
27/6/2020,七,沙頭角,出境,0,0,0,0
27/6/2020,七,深圳灣,入境,527,73,12,612
27/6/2020,七,深圳灣,出境,339,69,7,415
27/6/2020,七,中國客運碼頭,入境,0,0,0,0
27/6/2020,七,中國客運碼頭,出境,0,0,0,0
27/6/2020,七,港口管制,入境,0,0,0,0
27/6/2020,七,港口管制,出境,0,0,0,0
27/6/2020,七,啟德郵輪碼頭,入境,0,0,0,0
27/6/2020,七,啟德郵輪碼頭,出境,0,0,0,0
27/6/2020,七,港澳客輪碼頭,入境,0,0,0,0
27/6/2020,七,港澳客輪碼頭,出境,0,0,0,0
27/6/2020,七,屯門客運碼頭,入境,0,0,0,0
27/6/2020,七,屯門客運碼頭,出境,0,0,0,0
28/6/2020,七,機場,入境,928,5,69,1002
28/6/2020,七,機場,出境,874,1,103,978
28/6/2020,七,高鐵西九龍,入境,0,0,0,0
28/6/2020,七,高鐵西九龍,出境,0,0,0,0
28/6/2020,七,紅磡,入境,0,0,0,0
28/6/2020,七,紅磡,出境,0,0,0,0
28/6/2020,七,羅湖,入境,0,0,0,0
28/6/2020,七,羅湖,出境,0,0,0,0
28/6/2020,七,落馬洲支線,入境,0,0,0,0
28/6/2020,七,落馬洲支線,出境,0,0,0,0
28/6/2020,七,港珠澳大橋,入境,31,2,2,35
28/6/2020,七,港珠澳大橋,出境,39,0,3,42
28/6/2020,七,落馬洲,入境,0,0,0,0
28/6/2020,七,落馬洲,出境,0,0,0,0
28/6/2020,七,文錦渡,入境,0,0,0,0
28/6/2020,七,文錦渡,出境,0,0,0,0
28/6/2020,七,沙頭角,入境,0,0,0,0
28/6/2020,七,沙頭角,出境,0,0,0,0
28/6/2020,七,深圳灣,入境,608,117,11,736
28/6/2020,七,深圳灣,出境,309,42,19,370
28/6/2020,七,中國客運碼頭,入境,0,0,0,0
28/6/2020,七,中國客運碼頭,出境,0,0,0,0
28/6/2020,七,港口管制,入境,0,0,0,0
28/6/2020,七,港口管制,出境,0,0,0,0
28/6/2020,七,啟德郵輪碼頭,入境,0,0,0,0
28/6/2020,七,啟德郵輪碼頭,出境,0,0,0,0
28/6/2020,七,港澳客輪碼頭,入境,0,0,0,0
28/6/2020,七,港澳客輪碼頭,出境,0,0,0,0
28/6/2020,七,屯門客運碼頭,入境,0,0,0,0
28/6/2020,七,屯門客運碼頭,出境,0,0,0,0
29/6/2020,七,機場,入境,554,5,34,593
29/6/2020,七,機場,出境,336,4,108,448
29/6/2020,七,高鐵西九龍,入境,0,0,0,0
29/6/2020,七,高鐵西九龍,出境,0,0,0,0
29/6/2020,七,紅磡,入境,0,0,0,0
29/6/2020,七,紅磡,出境,0,0,0,0
29/6/2020,七,羅湖,入境,0,0,0,0
29/6/2020,七,羅湖,出境,0,0,0,0
29/6/2020,七,落馬洲支線,入境,1300,0,0,1300
29/6/2020,七,落馬洲支線,出境,1300,0,0,1300
29/6/2020,七,港珠澳大橋,入境,40,3,4,47
29/6/2020,七,港珠澳大橋,出境,76,4,3,83
29/6/2020,七,落馬洲,入境,0,0,0,0
29/6/2020,七,落馬洲,出境,0,0,0,0
29/6/2020,七,文錦渡,入境,0,0,0,0
29/6/2020,七,文錦渡,出境,0,0,0,0
29/6/2020,七,沙頭角,入境,0,0,0,0
29/6/2020,七,沙頭角,出境,0,0,0,0
29/6/2020,七,深圳灣,入境,865,80,6,951
29/6/2020,七,深圳灣,出境,774,52,20,846
29/6/2020,七,中國客運碼頭,入境,0,0,0,0
29/6/2020,七,中國客運碼頭,出境,0,0,0,0
29/6/2020,七,港口管制,入境,0,0,0,0
29/6/2020,七,港口管制,出境,0,0,0,0
29/6/2020,七,啟德郵輪碼頭,入境,0,0,0,0
29/6/2020,七,啟德郵輪碼頭,出境,0,0,0,0
29/6/2020,七,港澳客輪碼頭,入境,0,0,0,0
29/6/2020,七,港澳客輪碼頭,出境,0,0,0,0
29/6/2020,七,屯門客運碼頭,入境,0,0,0,0
29/6/2020,七,屯門客運碼頭,出境,0,0,0,0
30/6/2020,七,機場,入境,1221,7,82,1310
30/6/2020,七,機場,出境,730,5,62,797
30/6/2020,七,高鐵西九龍,入境,0,0,0,0
30/6/2020,七,高鐵西九龍,出境,0,0,0,0
30/6/2020,七,紅磡,入境,0,0,0,0
30/6/2020,七,紅磡,出境,0,0,0,0
30/6/2020,七,羅湖,入境,0,0,0,0
30/6/2020,七,羅湖,出境,0,0,0,0
30/6/2020,七,落馬洲支線,入境,1235,0,0,1235
30/6/2020,七,落馬洲支線,出境,1235,0,0,1235
30/6/2020,七,港珠澳大橋,入境,42,3,3,48
30/6/2020,七,港珠澳大橋,出境,88,4,6,98
30/6/2020,七,落馬洲,入境,0,0,0,0
30/6/2020,七,落馬洲,出境,0,0,0,0
30/6/2020,七,文錦渡,入境,0,0,0,0
30/6/2020,七,文錦渡,出境,0,0,0,0
30/6/2020,七,沙頭角,入境,0,0,0,0
30/6/2020,七,沙頭角,出境,0,0,0,0
30/6/2020,七,深圳灣,入境,928,159,10,1097
30/6/2020,七,深圳灣,出境,878,85,3,966
30/6/2020,七,中國客運碼頭,入境,0,0,0,0
30/6/2020,七,中國客運碼頭,出境,0,0,0,0
30/6/2020,七,港口管制,入境,0,0,0,0
30/6/2020,七,港口管制,出境,0,0,0,0
30/6/2020,七,啟德郵輪碼頭,入境,0,0,0,0
30/6/2020,七,啟德郵輪碼頭,出境,0,0,0,0
30/6/2020,七,港澳客輪碼頭,入境,0,0,0,0
30/6/2020,七,港澳客輪碼頭,出境,0,0,0,0
30/6/2020,七,屯門客運碼頭,入境,0,0,0,0
30/6/2020,七,屯門客運碼頭,出境,0,0,0,0
1/7/2020,八,機場,入境,682,3,58,743
1/7/2020,八,機場,出境,1022,20,82,1124
1/7/2020,八,高鐵西九龍,入境,0,0,0,0
1/7/2020,八,高鐵西九龍,出境,0,0,0,0
1/7/2020,八,紅磡,入境,0,0,0,0
1/7/2020,八,紅磡,出境,0,0,0,0
1/7/2020,八,羅湖,入境,0,0,0,0
1/7/2020,八,羅湖,出境,0,0,0,0
1/7/2020,八,落馬洲支線,入境,0,0,0,0
1/7/2020,八,落馬洲支線,出境,0,0,0,0
1/7/2020,八,港珠澳大橋,入境,41,7,4,52
1/7/2020,八,港珠澳大橋,出境,75,9,5,89
1/7/2020,八,落馬洲,入境,0,0,0,0
1/7/2020,八,落馬洲,出境,0,0,0,0
1/7/2020,八,文錦渡,入境,0,0,0,0
1/7/2020,八,文錦渡,出境,0,0,0,0
1/7/2020,八,沙頭角,入境,0,0,0,0
1/7/2020,八,沙頭角,出境,0,0,0,0
1/7/2020,八,深圳灣,入境,566,104,8,678
1/7/2020,八,深圳灣,出境,496,86,3,585
1/7/2020,八,中國客運碼頭,入境,0,0,0,0
1/7/2020,八,中國客運碼頭,出境,0,0,0,0
1/7/2020,八,港口管制,入境,0,0,0,0
1/7/2020,八,港口管制,出境,0,0,0,0
1/7/2020,八,啟德郵輪碼頭,入境,0,0,0,0
1/7/2020,八,啟德郵輪碼頭,出境,0,0,0,0
1/7/2020,八,港澳客輪碼頭,入境,0,0,0,0
1/7/2020,八,港澳客輪碼頭,出境,0,0,0,0
1/7/2020,八,屯門客運碼頭,入境,0,0,0,0
1/7/2020,八,屯門客運碼頭,出境,0,0,0,0
2/7/2020,八,機場,入境,1017,5,75,1097
2/7/2020,八,機場,出境,880,23,60,963
2/7/2020,八,高鐵西九龍,入境,0,0,0,0
2/7/2020,八,高鐵西九龍,出境,0,0,0,0
2/7/2020,八,紅磡,入境,0,0,0,0
2/7/2020,八,紅磡,出境,0,0,0,0
2/7/2020,八,羅湖,入境,0,0,0,0
2/7/2020,八,羅湖,出境,0,0,0,0
2/7/2020,八,落馬洲支線,入境,1291,0,0,1291
2/7/2020,八,落馬洲支線,出境,1291,0,0,1291
2/7/2020,八,港珠澳大橋,入境,73,1,3,77
2/7/2020,八,港珠澳大橋,出境,86,9,3,98
2/7/2020,八,落馬洲,入境,0,0,0,0
2/7/2020,八,落馬洲,出境,0,0,0,0
2/7/2020,八,文錦渡,入境,0,0,0,0
2/7/2020,八,文錦渡,出境,0,0,0,0
2/7/2020,八,沙頭角,入境,0,0,0,0
2/7/2020,八,沙頭角,出境,0,0,0,0
2/7/2020,八,深圳灣,入境,981,86,11,1078
2/7/2020,八,深圳灣,出境,918,88,8,1014
2/7/2020,八,中國客運碼頭,入境,0,0,0,0
2/7/2020,八,中國客運碼頭,出境,0,0,0,0
2/7/2020,八,港口管制,入境,0,0,0,0
2/7/2020,八,港口管制,出境,0,0,0,0
2/7/2020,八,啟德郵輪碼頭,入境,0,0,0,0
2/7/2020,八,啟德郵輪碼頭,出境,0,0,0,0
2/7/2020,八,港澳客輪碼頭,入境,0,0,0,0
2/7/2020,八,港澳客輪碼頭,出境,0,0,0,0
2/7/2020,八,屯門客運碼頭,入境,0,0,0,0
2/7/2020,八,屯門客運碼頭,出境,0,0,0,0
3/7/2020,八,機場,入境,1145,7,71,1223
3/7/2020,八,機場,出境,1054,17,87,1158
3/7/2020,八,高鐵西九龍,入境,0,0,0,0
3/7/2020,八,高鐵西九龍,出境,0,0,0,0
3/7/2020,八,紅磡,入境,0,0,0,0
3/7/2020,八,紅磡,出境,0,0,0,0
3/7/2020,八,羅湖,入境,0,0,0,0
3/7/2020,八,羅湖,出境,0,0,0,0
3/7/2020,八,落馬洲支線,入境,1219,0,0,1219
3/7/2020,八,落馬洲支線,出境,1219,0,0,1219
3/7/2020,八,港珠澳大橋,入境,57,7,3,67
3/7/2020,八,港珠澳大橋,出境,84,6,7,97
3/7/2020,八,落馬洲,入境,0,0,0,0
3/7/2020,八,落馬洲,出境,0,0,0,0
3/7/2020,八,文錦渡,入境,0,0,0,0
3/7/2020,八,文錦渡,出境,0,0,0,0
3/7/2020,八,沙頭角,入境,0,0,0,0
3/7/2020,八,沙頭角,出境,0,0,0,0
3/7/2020,八,深圳灣,入境,1063,134,5,1202
3/7/2020,八,深圳灣,出境,868,107,14,989
3/7/2020,八,中國客運碼頭,入境,0,0,0,0
3/7/2020,八,中國客運碼頭,出境,0,0,0,0
3/7/2020,八,港口管制,入境,0,0,0,0
3/7/2020,八,港口管制,出境,0,0,0,0
3/7/2020,八,啟德郵輪碼頭,入境,0,0,0,0
3/7/2020,八,啟德郵輪碼頭,出境,0,0,0,0
3/7/2020,八,港澳客輪碼頭,入境,0,0,0,0
3/7/2020,八,港澳客輪碼頭,出境,0,0,0,0
3/7/2020,八,屯門客運碼頭,入境,0,0,0,0
3/7/2020,八,屯門客運碼頭,出境,0,0,0,0
4/7/2020,八,機場,入境,1068,13,57,1138
4/7/2020,八,機場,出境,809,9,133,951
4/7/2020,八,高鐵西九龍,入境,0,0,0,0
4/7/2020,八,高鐵西九龍,出境,0,0,0,0
4/7/2020,八,紅磡,入境,0,0,0,0
4/7/2020,八,紅磡,出境,0,0,0,0
4/7/2020,八,羅湖,入境,0,0,0,0
4/7/2020,八,羅湖,出境,0,0,0,0
4/7/2020,八,落馬洲支線,入境,0,0,0,0
4/7/2020,八,落馬洲支線,出境,0,0,0,0
4/7/2020,八,港珠澳大橋,入境,66,8,3,77
4/7/2020,八,港珠澳大橋,出境,79,3,5,87
4/7/2020,八,落馬洲,入境,0,0,0,0
4/7/2020,八,落馬洲,出境,0,0,0,0
4/7/2020,八,文錦渡,入境,0,0,0,0
4/7/2020,八,文錦渡,出境,0,0,0,0
4/7/2020,八,沙頭角,入境,0,0,0,0
4/7/2020,八,沙頭角,出境,0,0,0,0
4/7/2020,八,深圳灣,入境,746,145,11,902
4/7/2020,八,深圳灣,出境,707,109,14,830
4/7/2020,八,中國客運碼頭,入境,0,0,0,0
4/7/2020,八,中國客運碼頭,出境,0,0,0,0
4/7/2020,八,港口管制,入境,0,0,0,0
4/7/2020,八,港口管制,出境,0,0,0,0
4/7/2020,八,啟德郵輪碼頭,入境,0,0,0,0
4/7/2020,八,啟德郵輪碼頭,出境,0,0,0,0
4/7/2020,八,港澳客輪碼頭,入境,0,0,0,0
4/7/2020,八,港澳客輪碼頭,出境,0,0,0,0
4/7/2020,八,屯門客運碼頭,入境,0,0,0,0
4/7/2020,八,屯門客運碼頭,出境,0,0,0,0
5/7/2020,八,機場,入境,1276,6,48,1330
5/7/2020,八,機場,出境,994,14,151,1159
5/7/2020,八,高鐵西九龍,入境,0,0,0,0
5/7/2020,八,高鐵西九龍,出境,0,0,0,0
5/7/2020,八,紅磡,入境,0,0,0,0
5/7/2020,八,紅磡,出境,0,0,0,0
5/7/2020,八,羅湖,入境,0,0,0,0
5/7/2020,八,羅湖,出境,0,0,0,0
5/7/2020,八,落馬洲支線,入境,0,0,0,0
5/7/2020,八,落馬洲支線,出境,0,0,0,0
5/7/2020,八,港珠澳大橋,入境,70,6,4,80
5/7/2020,八,港珠澳大橋,出境,89,12,2,103
5/7/2020,八,落馬洲,入境,0,0,0,0
5/7/2020,八,落馬洲,出境,0,0,0,0
5/7/2020,八,文錦渡,入境,0,0,0,0
5/7/2020,八,文錦渡,出境,0,0,0,0
5/7/2020,八,沙頭角,入境,0,0,0,0
5/7/2020,八,沙頭角,出境,0,0,0,0
5/7/2020,八,深圳灣,入境,942,197,13,1152
5/7/2020,八,深圳灣,出境,664,131,4,799
5/7/2020,八,中國客運碼頭,入境,0,0,0,0
5/7/2020,八,中國客運碼頭,出境,0,0,0,0
5/7/2020,八,港口管制,入境,0,0,0,0
5/7/2020,八,港口管制,出境,0,0,0,0
5/7/2020,八,啟德郵輪碼頭,入境,0,0,0,0
5/7/2020,八,啟德郵輪碼頭,出境,0,0,0,0
5/7/2020,八,港澳客輪碼頭,入境,0,0,0,0
5/7/2020,八,港澳客輪碼頭,出境,0,0,0,0
5/7/2020,八,屯門客運碼頭,入境,0,0,0,0
5/7/2020,八,屯門客運碼頭,出境,0,0,0,0
6/7/2020,八,機場,入境,843,4,46,893
6/7/2020,八,機場,出境,312,2,110,424
6/7/2020,八,高鐵西九龍,入境,0,0,0,0
6/7/2020,八,高鐵西九龍,出境,0,0,0,0
6/7/2020,八,紅磡,入境,0,0,0,0
6/7/2020,八,紅磡,出境,0,0,0,0
6/7/2020,八,羅湖,入境,0,0,0,0
6/7/2020,八,羅湖,出境,0,0,0,0
6/7/2020,八,落馬洲支線,入境,1133,0,0,1133
6/7/2020,八,落馬洲支線,出境,1133,0,0,1133
6/7/2020,八,港珠澳大橋,入境,106,2,3,111
6/7/2020,八,港珠澳大橋,出境,113,6,4,123
6/7/2020,八,落馬洲,入境,0,0,0,0
6/7/2020,八,落馬洲,出境,0,0,0,0
6/7/2020,八,文錦渡,入境,0,0,0,0
6/7/2020,八,文錦渡,出境,0,0,0,0
6/7/2020,八,沙頭角,入境,0,0,0,0
6/7/2020,八,沙頭角,出境,0,0,0,0
6/7/2020,八,深圳灣,入境,1318,137,16,1471
6/7/2020,八,深圳灣,出境,1040,117,16,1173
6/7/2020,八,中國客運碼頭,入境,0,0,0,0
6/7/2020,八,中國客運碼頭,出境,0,0,0,0
6/7/2020,八,港口管制,入境,0,0,0,0
6/7/2020,八,港口管制,出境,0,0,0,0
6/7/2020,八,啟德郵輪碼頭,入境,0,0,0,0
6/7/2020,八,啟德郵輪碼頭,出境,0,0,0,0
6/7/2020,八,港澳客輪碼頭,入境,0,0,0,0
6/7/2020,八,港澳客輪碼頭,出境,0,0,0,0
6/7/2020,八,屯門客運碼頭,入境,0,0,0,0
6/7/2020,八,屯門客運碼頭,出境,0,0,0,0
7/7/2020,八,機場,入境,1044,8,36,1088
7/7/2020,八,機場,出境,819,18,81,918
7/7/2020,八,高鐵西九龍,入境,0,0,0,0
7/7/2020,八,高鐵西九龍,出境,0,0,0,0
7/7/2020,八,紅磡,入境,0,0,0,0
7/7/2020,八,紅磡,出境,0,0,0,0
7/7/2020,八,羅湖,入境,0,0,0,0
7/7/2020,八,羅湖,出境,0,0,0,0
7/7/2020,八,落馬洲支線,入境,1186,0,0,1186
7/7/2020,八,落馬洲支線,出境,1186,0,0,1186
7/7/2020,八,港珠澳大橋,入境,104,4,9,117
7/7/2020,八,港珠澳大橋,出境,138,5,8,151
7/7/2020,八,落馬洲,入境,0,0,0,0
7/7/2020,八,落馬洲,出境,0,0,0,0
7/7/2020,八,文錦渡,入境,0,0,0,0
7/7/2020,八,文錦渡,出境,0,0,0,0
7/7/2020,八,沙頭角,入境,0,0,0,0
7/7/2020,八,沙頭角,出境,0,0,0,0
7/7/2020,八,深圳灣,入境,1279,155,14,1448
7/7/2020,八,深圳灣,出境,1106,130,6,1242
7/7/2020,八,中國客運碼頭,入境,0,0,0,0
7/7/2020,八,中國客運碼頭,出境,0,0,0,0
7/7/2020,八,港口管制,入境,0,0,0,0
7/7/2020,八,港口管制,出境,0,0,0,0
7/7/2020,八,啟德郵輪碼頭,入境,0,0,0,0
7/7/2020,八,啟德郵輪碼頭,出境,0,0,0,0
7/7/2020,八,港澳客輪碼頭,入境,0,0,0,0
7/7/2020,八,港澳客輪碼頭,出境,0,0,0,0
7/7/2020,八,屯門客運碼頭,入境,0,0,0,0
7/7/2020,八,屯門客運碼頭,出境,0,0,0,0
8/7/2020,八,機場,入境,1091,11,76,1178
8/7/2020,八,機場,出境,774,5,197,976
8/7/2020,八,高鐵西九龍,入境,0,0,0,0
8/7/2020,八,高鐵西九龍,出境,0,0,0,0
8/7/2020,八,紅磡,入境,0,0,0,0
8/7/2020,八,紅磡,出境,0,0,0,0
8/7/2020,八,羅湖,入境,0,0,0,0
8/7/2020,八,羅湖,出境,0,0,0,0
8/7/2020,八,落馬洲支線,入境,1030,0,0,1030
8/7/2020,八,落馬洲支線,出境,1030,0,0,1030
8/7/2020,八,港珠澳大橋,入境,122,6,6,134
8/7/2020,八,港珠澳大橋,出境,172,7,8,187
8/7/2020,八,落馬洲,入境,0,0,0,0
8/7/2020,八,落馬洲,出境,0,0,0,0
8/7/2020,八,文錦渡,入境,0,0,0,0
8/7/2020,八,文錦渡,出境,0,0,0,0
8/7/2020,八,沙頭角,入境,0,0,0,0
8/7/2020,八,沙頭角,出境,0,0,0,0
8/7/2020,八,深圳灣,入境,1428,184,20,1632
8/7/2020,八,深圳灣,出境,1341,175,5,1521
8/7/2020,八,中國客運碼頭,入境,0,0,0,0
8/7/2020,八,中國客運碼頭,出境,0,0,0,0
8/7/2020,八,港口管制,入境,0,0,0,0
8/7/2020,八,港口管制,出境,0,0,0,0
8/7/2020,八,啟德郵輪碼頭,入境,0,0,0,0
8/7/2020,八,啟德郵輪碼頭,出境,0,0,0,0
8/7/2020,八,港澳客輪碼頭,入境,0,0,0,0
8/7/2020,八,港澳客輪碼頭,出境,0,0,0,0
8/7/2020,八,屯門客運碼頭,入境,0,0,0,0
8/7/2020,八,屯門客運碼頭,出境,0,0,0,0
9/7/2020,八,機場,入境,661,9,44,714
9/7/2020,八,機場,出境,727,21,84,832
9/7/2020,八,高鐵西九龍,入境,0,0,0,0
9/7/2020,八,高鐵西九龍,出境,0,0,0,0
9/7/2020,八,紅磡,入境,0,0,0,0
9/7/2020,八,紅磡,出境,0,0,0,0
9/7/2020,八,羅湖,入境,0,0,0,0
9/7/2020,八,羅湖,出境,0,0,0,0
9/7/2020,八,落馬洲支線,入境,721,0,0,721
9/7/2020,八,落馬洲支線,出境,721,0,0,721
9/7/2020,八,港珠澳大橋,入境,98,5,3,106
9/7/2020,八,港珠澳大橋,出境,212,10,8,230
9/7/2020,八,落馬洲,入境,0,0,0,0
9/7/2020,八,落馬洲,出境,0,0,0,0
9/7/2020,八,文錦渡,入境,0,0,0,0
9/7/2020,八,文錦渡,出境,0,0,0,0
9/7/2020,八,沙頭角,入境,0,0,0,0
9/7/2020,八,沙頭角,出境,0,0,0,0
9/7/2020,八,深圳灣,入境,1336,161,7,1504
9/7/2020,八,深圳灣,出境,1178,195,9,1382
9/7/2020,八,中國客運碼頭,入境,0,0,0,0
9/7/2020,八,中國客運碼頭,出境,0,0,0,0
9/7/2020,八,港口管制,入境,0,0,0,0
9/7/2020,八,港口管制,出境,0,0,0,0
9/7/2020,八,啟德郵輪碼頭,入境,0,0,0,0
9/7/2020,八,啟德郵輪碼頭,出境,0,0,0,0
9/7/2020,八,港澳客輪碼頭,入境,0,0,0,0
9/7/2020,八,港澳客輪碼頭,出境,0,0,0,0
9/7/2020,八,屯門客運碼頭,入境,0,0,0,0
9/7/2020,八,屯門客運碼頭,出境,0,0,0,0
10/7/2020,八,機場,入境,1298,2,105,1405
10/7/2020,八,機場,出境,852,29,96,977
10/7/2020,八,高鐵西九龍,入境,0,0,0,0
10/7/2020,八,高鐵西九龍,出境,0,0,0,0
10/7/2020,八,紅磡,入境,0,0,0,0
10/7/2020,八,紅磡,出境,0,0,0,0
10/7/2020,八,羅湖,入境,0,0,0,0
10/7/2020,八,羅湖,出境,0,0,0,0
10/7/2020,八,落馬洲支線,入境,827,0,0,827
10/7/2020,八,落馬洲支線,出境,827,0,0,827
10/7/2020,八,港珠澳大橋,入境,102,11,5,118
10/7/2020,八,港珠澳大橋,出境,239,23,16,278
10/7/2020,八,落馬洲,入境,0,0,0,0
10/7/2020,八,落馬洲,出境,0,0,0,0
10/7/2020,八,文錦渡,入境,0,0,0,0
10/7/2020,八,文錦渡,出境,0,0,0,0
10/7/2020,八,沙頭角,入境,0,0,0,0
10/7/2020,八,沙頭角,出境,0,0,0,0
10/7/2020,八,深圳灣,入境,1102,162,10,1274
10/7/2020,八,深圳灣,出境,1567,229,16,1812
10/7/2020,八,中國客運碼頭,入境,0,0,0,0
10/7/2020,八,中國客運碼頭,出境,0,0,0,0
10/7/2020,八,港口管制,入境,0,0,0,0
10/7/2020,八,港口管制,出境,0,0,0,0
10/7/2020,八,啟德郵輪碼頭,入境,0,0,0,0
10/7/2020,八,啟德郵輪碼頭,出境,0,0,0,0
10/7/2020,八,港澳客輪碼頭,入境,0,0,0,0
10/7/2020,八,港澳客輪碼頭,出境,0,0,0,0
10/7/2020,八,屯門客運碼頭,入境,0,0,0,0
10/7/2020,八,屯門客運碼頭,出境,0,0,0,0
11/7/2020,八,機場,入境,1248,13,75,1336
11/7/2020,八,機場,出境,791,19,92,902
11/7/2020,八,高鐵西九龍,入境,0,0,0,0
11/7/2020,八,高鐵西九龍,出境,0,0,0,0
11/7/2020,八,紅磡,入境,0,0,0,0
11/7/2020,八,紅磡,出境,0,0,0,0
11/7/2020,八,羅湖,入境,0,0,0,0
11/7/2020,八,羅湖,出境,0,0,0,0
11/7/2020,八,落馬洲支線,入境,0,0,0,0
11/7/2020,八,落馬洲支線,出境,0,0,0,0
11/7/2020,八,港珠澳大橋,入境,75,2,7,84
11/7/2020,八,港珠澳大橋,出境,263,41,9,313
11/7/2020,八,落馬洲,入境,0,0,0,0
11/7/2020,八,落馬洲,出境,0,0,0,0
11/7/2020,八,文錦渡,入境,0,0,0,0
11/7/2020,八,文錦渡,出境,0,0,0,0
11/7/2020,八,沙頭角,入境,0,0,0,0
11/7/2020,八,沙頭角,出境,0,0,0,0
11/7/2020,八,深圳灣,入境,737,159,10,906
11/7/2020,八,深圳灣,出境,2017,427,11,2455
11/7/2020,八,中國客運碼頭,入境,0,0,0,0
11/7/2020,八,中國客運碼頭,出境,0,0,0,0
11/7/2020,八,港口管制,入境,0,0,0,0
11/7/2020,八,港口管制,出境,0,0,0,0
11/7/2020,八,啟德郵輪碼頭,入境,0,0,0,0
11/7/2020,八,啟德郵輪碼頭,出境,0,0,0,0
11/7/2020,八,港澳客輪碼頭,入境,0,0,0,0
11/7/2020,八,港澳客輪碼頭,出境,0,0,0,0
11/7/2020,八,屯門客運碼頭,入境,0,0,0,0
11/7/2020,八,屯門客運碼頭,出境,0,0,0,0
12/7/2020,八,機場,入境,1105,10,79,1194
12/7/2020,八,機場,出境,1114,61,109,1284
12/7/2020,八,高鐵西九龍,入境,0,0,0,0
12/7/2020,八,高鐵西九龍,出境,0,0,0,0
12/7/2020,八,紅磡,入境,0,0,0,0
12/7/2020,八,紅磡,出境,0,0,0,0
12/7/2020,八,羅湖,入境,0,0,0,0
12/7/2020,八,羅湖,出境,0,0,0,0
12/7/2020,八,落馬洲支線,入境,0,0,0,0
12/7/2020,八,落馬洲支線,出境,0,0,0,0
12/7/2020,八,港珠澳大橋,入境,71,6,9,86
12/7/2020,八,港珠澳大橋,出境,259,34,5,298
12/7/2020,八,落馬洲,入境,0,0,0,0
12/7/2020,八,落馬洲,出境,0,0,0,0
12/7/2020,八,文錦渡,入境,0,0,0,0
12/7/2020,八,文錦渡,出境,0,0,0,0
12/7/2020,八,沙頭角,入境,0,0,0,0
12/7/2020,八,沙頭角,出境,0,0,0,0
12/7/2020,八,深圳灣,入境,826,116,7,949
12/7/2020,八,深圳灣,出境,1528,339,17,1884
12/7/2020,八,中國客運碼頭,入境,0,0,0,0
12/7/2020,八,中國客運碼頭,出境,0,0,0,0
12/7/2020,八,港口管制,入境,0,0,0,0
12/7/2020,八,港口管制,出境,0,0,0,0
12/7/2020,八,啟德郵輪碼頭,入境,0,0,0,0
12/7/2020,八,啟德郵輪碼頭,出境,0,0,0,0
12/7/2020,八,港澳客輪碼頭,入境,0,0,0,0
12/7/2020,八,港澳客輪碼頭,出境,0,0,0,0
12/7/2020,八,屯門客運碼頭,入境,0,0,0,0
12/7/2020,八,屯門客運碼頭,出境,0,0,0,0
13/7/2020,八,機場,入境,731,9,55,795
13/7/2020,八,機場,出境,326,30,62,418
13/7/2020,八,高鐵西九龍,入境,0,0,0,0
13/7/2020,八,高鐵西九龍,出境,0,0,0,0
13/7/2020,八,紅磡,入境,0,0,0,0
13/7/2020,八,紅磡,出境,0,0,0,0
13/7/2020,八,羅湖,入境,0,0,0,0
13/7/2020,八,羅湖,出境,0,0,0,0
13/7/2020,八,落馬洲支線,入境,151,0,0,151
13/7/2020,八,落馬洲支線,出境,151,0,0,151
13/7/2020,八,港珠澳大橋,入境,99,2,3,104
13/7/2020,八,港珠澳大橋,出境,393,43,4,440
13/7/2020,八,落馬洲,入境,0,0,0,0
13/7/2020,八,落馬洲,出境,0,0,0,0
13/7/2020,八,文錦渡,入境,0,0,0,0
13/7/2020,八,文錦渡,出境,0,0,0,0
13/7/2020,八,沙頭角,入境,0,0,0,0
13/7/2020,八,沙頭角,出境,0,0,0,0
13/7/2020,八,深圳灣,入境,935,109,11,1055
13/7/2020,八,深圳灣,出境,2326,355,21,2702
13/7/2020,八,中國客運碼頭,入境,0,0,0,0
13/7/2020,八,中國客運碼頭,出境,0,0,0,0
13/7/2020,八,港口管制,入境,0,0,0,0
13/7/2020,八,港口管制,出境,0,0,0,0
13/7/2020,八,啟德郵輪碼頭,入境,0,0,0,0
13/7/2020,八,啟德郵輪碼頭,出境,0,0,0,0
13/7/2020,八,港澳客輪碼頭,入境,0,0,0,0
13/7/2020,八,港澳客輪碼頭,出境,0,0,0,0
13/7/2020,八,屯門客運碼頭,入境,0,0,0,0
13/7/2020,八,屯門客運碼頭,出境,0,0,0,0
14/7/2020,八,機場,入境,768,8,55,831
14/7/2020,八,機場,出境,1082,66,84,1232
14/7/2020,八,高鐵西九龍,入境,0,0,0,0
14/7/2020,八,高鐵西九龍,出境,0,0,0,0
14/7/2020,八,紅磡,入境,0,0,0,0
14/7/2020,八,紅磡,出境,0,0,0,0
14/7/2020,八,羅湖,入境,0,0,0,0
14/7/2020,八,羅湖,出境,0,0,0,0
14/7/2020,八,落馬洲支線,入境,57,0,0,57
14/7/2020,八,落馬洲支線,出境,57,0,0,57
14/7/2020,八,港珠澳大橋,入境,47,2,1,50
14/7/2020,八,港珠澳大橋,出境,516,65,5,586
14/7/2020,八,落馬洲,入境,0,0,0,0
14/7/2020,八,落馬洲,出境,0,0,0,0
14/7/2020,八,文錦渡,入境,0,0,0,0
14/7/2020,八,文錦渡,出境,0,0,0,0
14/7/2020,八,沙頭角,入境,0,0,0,0
14/7/2020,八,沙頭角,出境,0,0,0,0
14/7/2020,八,深圳灣,入境,715,88,7,810
14/7/2020,八,深圳灣,出境,2694,469,19,3182
14/7/2020,八,中國客運碼頭,入境,0,0,0,0
14/7/2020,八,中國客運碼頭,出境,0,0,0,0
14/7/2020,八,港口管制,入境,0,0,0,0
14/7/2020,八,港口管制,出境,0,0,0,0
14/7/2020,八,啟德郵輪碼頭,入境,0,0,0,0
14/7/2020,八,啟德郵輪碼頭,出境,0,0,0,0
14/7/2020,八,港澳客輪碼頭,入境,0,0,0,0
14/7/2020,八,港澳客輪碼頭,出境,0,0,0,0
14/7/2020,八,屯門客運碼頭,入境,0,0,0,0
14/7/2020,八,屯門客運碼頭,出境,0,0,0,0
15/7/2020,八,機場,入境,1035,3,58,1096
15/7/2020,八,機場,出境,880,20,74,974
15/7/2020,八,高鐵西九龍,入境,0,0,0,0
15/7/2020,八,高鐵西九龍,出境,0,0,0,0
15/7/2020,八,紅磡,入境,0,0,0,0
15/7/2020,八,紅磡,出境,0,0,0,0
15/7/2020,八,羅湖,入境,0,0,0,0
15/7/2020,八,羅湖,出境,0,0,0,0
15/7/2020,八,落馬洲支線,入境,65,0,0,65
15/7/2020,八,落馬洲支線,出境,65,0,0,65
15/7/2020,八,港珠澳大橋,入境,98,3,3,104
15/7/2020,八,港珠澳大橋,出境,637,87,8,732
15/7/2020,八,落馬洲,入境,0,0,0,0
15/7/2020,八,落馬洲,出境,0,0,0,0
15/7/2020,八,文錦渡,入境,0,0,0,0
15/7/2020,八,文錦渡,出境,0,0,0,0
15/7/2020,八,沙頭角,入境,0,0,0,0
15/7/2020,八,沙頭角,出境,0,0,0,0
15/7/2020,八,深圳灣,入境,752,83,7,842
15/7/2020,八,深圳灣,出境,2660,470,16,3146
15/7/2020,八,中國客運碼頭,入境,0,0,0,0
15/7/2020,八,中國客運碼頭,出境,0,0,0,0
15/7/2020,八,港口管制,入境,0,0,0,0
15/7/2020,八,港口管制,出境,0,0,0,0
15/7/2020,八,啟德郵輪碼頭,入境,0,0,0,0
15/7/2020,八,啟德郵輪碼頭,出境,0,0,0,0
15/7/2020,八,港澳客輪碼頭,入境,0,0,0,0
15/7/2020,八,港澳客輪碼頭,出境,0,0,0,0
15/7/2020,八,屯門客運碼頭,入境,0,0,0,0
15/7/2020,八,屯門客運碼頭,出境,0,0,0,0
16/7/2020,八,機場,入境,516,3,28,547
16/7/2020,八,機場,出境,706,24,36,766
16/7/2020,八,高鐵西九龍,入境,0,0,0,0
16/7/2020,八,高鐵西九龍,出境,0,0,0,0
16/7/2020,八,紅磡,入境,0,0,0,0
16/7/2020,八,紅磡,出境,0,0,0,0
16/7/2020,八,羅湖,入境,0,0,0,0
16/7/2020,八,羅湖,出境,0,0,0,0
16/7/2020,八,落馬洲支線,入境,58,0,0,58
16/7/2020,八,落馬洲支線,出境,58,0,0,58
16/7/2020,八,港珠澳大橋,入境,91,5,8,104
16/7/2020,八,港珠澳大橋,出境,538,66,8,612
16/7/2020,八,落馬洲,入境,0,0,0,0
16/7/2020,八,落馬洲,出境,0,0,0,0
16/7/2020,八,文錦渡,入境,0,0,0,0
16/7/2020,八,文錦渡,出境,0,0,0,0
16/7/2020,八,沙頭角,入境,0,0,0,0
16/7/2020,八,沙頭角,出境,0,0,0,0
16/7/2020,八,深圳灣,入境,651,85,8,744
16/7/2020,八,深圳灣,出境,2576,346,16,2938
16/7/2020,八,中國客運碼頭,入境,0,0,0,0
16/7/2020,八,中國客運碼頭,出境,0,0,0,0
16/7/2020,八,港口管制,入境,0,0,0,0
16/7/2020,八,港口管制,出境,0,0,0,0
16/7/2020,八,啟德郵輪碼頭,入境,0,0,0,0
16/7/2020,八,啟德郵輪碼頭,出境,0,0,0,0
16/7/2020,八,港澳客輪碼頭,入境,0,0,0,0
16/7/2020,八,港澳客輪碼頭,出境,0,0,0,0
16/7/2020,八,屯門客運碼頭,入境,0,0,0,0
16/7/2020,八,屯門客運碼頭,出境,0,0,0,0
17/7/2020,八,機場,入境,1073,7,82,1162
17/7/2020,八,機場,出境,1209,51,72,1332
17/7/2020,八,高鐵西九龍,入境,0,0,0,0
17/7/2020,八,高鐵西九龍,出境,0,0,0,0
17/7/2020,八,紅磡,入境,0,0,0,0
17/7/2020,八,紅磡,出境,0,0,0,0
17/7/2020,八,羅湖,入境,0,0,0,0
17/7/2020,八,羅湖,出境,0,0,0,0
17/7/2020,八,落馬洲支線,入境,37,0,0,37
17/7/2020,八,落馬洲支線,出境,37,0,0,37
17/7/2020,八,港珠澳大橋,入境,69,2,3,74
17/7/2020,八,港珠澳大橋,出境,94,1,3,98
17/7/2020,八,落馬洲,入境,0,0,0,0
17/7/2020,八,落馬洲,出境,0,0,0,0
17/7/2020,八,文錦渡,入境,0,0,0,0
17/7/2020,八,文錦渡,出境,0,0,0,0
17/7/2020,八,沙頭角,入境,0,0,0,0
17/7/2020,八,沙頭角,出境,0,0,0,0
17/7/2020,八,深圳灣,入境,588,54,16,658
17/7/2020,八,深圳灣,出境,360,45,11,416
17/7/2020,八,中國客運碼頭,入境,0,0,0,0
17/7/2020,八,中國客運碼頭,出境,0,0,0,0
17/7/2020,八,港口管制,入境,0,0,0,0
17/7/2020,八,港口管制,出境,0,0,0,0
17/7/2020,八,啟德郵輪碼頭,入境,0,0,0,0
17/7/2020,八,啟德郵輪碼頭,出境,0,0,0,0
17/7/2020,八,港澳客輪碼頭,入境,0,0,0,0
17/7/2020,八,港澳客輪碼頭,出境,0,0,0,0
17/7/2020,八,屯門客運碼頭,入境,0,0,0,0
17/7/2020,八,屯門客運碼頭,出境,0,0,0,0
18/7/2020,八,機場,入境,693,12,45,750
18/7/2020,八,機場,出境,1074,65,69,1208
18/7/2020,八,高鐵西九龍,入境,0,0,0,0
18/7/2020,八,高鐵西九龍,出境,0,0,0,0
18/7/2020,八,紅磡,入境,0,0,0,0
18/7/2020,八,紅磡,出境,0,0,0,0
18/7/2020,八,羅湖,入境,0,0,0,0
18/7/2020,八,羅湖,出境,0,0,0,0
18/7/2020,八,落馬洲支線,入境,0,0,0,0
18/7/2020,八,落馬洲支線,出境,0,0,0,0
18/7/2020,八,港珠澳大橋,入境,58,3,5,66
18/7/2020,八,港珠澳大橋,出境,153,16,7,176
18/7/2020,八,落馬洲,入境,0,0,0,0
18/7/2020,八,落馬洲,出境,0,0,0,0
18/7/2020,八,文錦渡,入境,0,0,0,0
18/7/2020,八,文錦渡,出境,0,0,0,0
18/7/2020,八,沙頭角,入境,0,0,0,0
18/7/2020,八,沙頭角,出境,0,0,0,0
18/7/2020,八,深圳灣,入境,472,75,4,551
18/7/2020,八,深圳灣,出境,745,68,9,822
18/7/2020,八,中國客運碼頭,入境,0,0,0,0
18/7/2020,八,中國客運碼頭,出境,0,0,0,0
18/7/2020,八,港口管制,入境,0,0,0,0
18/7/2020,八,港口管制,出境,0,0,0,0
18/7/2020,八,啟德郵輪碼頭,入境,0,0,0,0
18/7/2020,八,啟德郵輪碼頭,出境,0,0,0,0
18/7/2020,八,港澳客輪碼頭,入境,0,0,0,0
18/7/2020,八,港澳客輪碼頭,出境,0,0,0,0
18/7/2020,八,屯門客運碼頭,入境,0,0,0,0
18/7/2020,八,屯門客運碼頭,出境,0,0,0,0
19/7/2020,八,機場,入境,912,2,42,956
19/7/2020,八,機場,出境,1428,73,109,1610
19/7/2020,八,高鐵西九龍,入境,0,0,0,0
19/7/2020,八,高鐵西九龍,出境,0,0,0,0
19/7/2020,八,紅磡,入境,0,0,0,0
19/7/2020,八,紅磡,出境,0,0,0,0
19/7/2020,八,羅湖,入境,0,0,0,0
19/7/2020,八,羅湖,出境,0,0,0,0
19/7/2020,八,落馬洲支線,入境,0,0,0,0
19/7/2020,八,落馬洲支線,出境,0,0,0,0
19/7/2020,八,港珠澳大橋,入境,32,4,5,41
19/7/2020,八,港珠澳大橋,出境,141,5,4,150
19/7/2020,八,落馬洲,入境,0,0,0,0
19/7/2020,八,落馬洲,出境,0,0,0,0
19/7/2020,八,文錦渡,入境,0,0,0,0
19/7/2020,八,文錦渡,出境,0,0,0,0
19/7/2020,八,沙頭角,入境,0,0,0,0
19/7/2020,八,沙頭角,出境,0,0,0,0
19/7/2020,八,深圳灣,入境,435,78,7,520
19/7/2020,八,深圳灣,出境,674,109,7,790
19/7/2020,八,中國客運碼頭,入境,0,0,0,0
19/7/2020,八,中國客運碼頭,出境,0,0,0,0
19/7/2020,八,港口管制,入境,0,0,0,0
19/7/2020,八,港口管制,出境,0,0,0,0
19/7/2020,八,啟德郵輪碼頭,入境,0,0,0,0
19/7/2020,八,啟德郵輪碼頭,出境,0,0,0,0
19/7/2020,八,港澳客輪碼頭,入境,0,0,0,0
19/7/2020,八,港澳客輪碼頭,出境,0,0,0,0
19/7/2020,八,屯門客運碼頭,入境,0,0,0,0
19/7/2020,八,屯門客運碼頭,出境,0,0,0,0
20/7/2020,八,機場,入境,605,2,27,634
20/7/2020,八,機場,出境,794,41,113,948
20/7/2020,八,高鐵西九龍,入境,0,0,0,0
20/7/2020,八,高鐵西九龍,出境,0,0,0,0
20/7/2020,八,紅磡,入境,0,0,0,0
20/7/2020,八,紅磡,出境,0,0,0,0
20/7/2020,八,羅湖,入境,0,0,0,0
20/7/2020,八,羅湖,出境,0,0,0,0
20/7/2020,八,落馬洲支線,入境,0,0,0,0
20/7/2020,八,落馬洲支線,出境,0,0,0,0
20/7/2020,八,港珠澳大橋,入境,45,3,2,50
20/7/2020,八,港珠澳大橋,出境,156,11,2,169
20/7/2020,八,落馬洲,入境,0,0,0,0
20/7/2020,八,落馬洲,出境,0,0,0,0
20/7/2020,八,文錦渡,入境,0,0,0,0
20/7/2020,八,文錦渡,出境,0,0,0,0
20/7/2020,八,沙頭角,入境,0,0,0,0
20/7/2020,八,沙頭角,出境,0,0,0,0
20/7/2020,八,深圳灣,入境,535,68,12,615
20/7/2020,八,深圳灣,出境,798,114,18,930
20/7/2020,八,中國客運碼頭,入境,0,0,0,0
20/7/2020,八,中國客運碼頭,出境,0,0,0,0
20/7/2020,八,港口管制,入境,0,0,0,0
20/7/2020,八,港口管制,出境,0,0,0,0
20/7/2020,八,啟德郵輪碼頭,入境,0,0,0,0
20/7/2020,八,啟德郵輪碼頭,出境,0,0,0,0
20/7/2020,八,港澳客輪碼頭,入境,0,0,0,0
20/7/2020,八,港澳客輪碼頭,出境,0,0,0,0
20/7/2020,八,屯門客運碼頭,入境,0,0,0,0
20/7/2020,八,屯門客運碼頭,出境,0,0,0,0
21/7/2020,八,機場,入境,728,3,49,780
21/7/2020,八,機場,出境,1501,95,72,1668
21/7/2020,八,高鐵西九龍,入境,0,0,0,0
21/7/2020,八,高鐵西九龍,出境,0,0,0,0
21/7/2020,八,紅磡,入境,0,0,0,0
21/7/2020,八,紅磡,出境,0,0,0,0
21/7/2020,八,羅湖,入境,0,0,0,0
21/7/2020,八,羅湖,出境,0,0,0,0
21/7/2020,八,落馬洲支線,入境,0,0,0,0
21/7/2020,八,落馬洲支線,出境,0,0,0,0
21/7/2020,八,港珠澳大橋,入境,35,2,0,37
21/7/2020,八,港珠澳大橋,出境,200,12,3,215
21/7/2020,八,落馬洲,入境,0,0,0,0
21/7/2020,八,落馬洲,出境,0,0,0,0
21/7/2020,八,文錦渡,入境,0,0,0,0
21/7/2020,八,文錦渡,出境,0,0,0,0
21/7/2020,八,沙頭角,入境,0,0,0,0
21/7/2020,八,沙頭角,出境,0,0,0,0
21/7/2020,八,深圳灣,入境,386,45,6,437
21/7/2020,八,深圳灣,出境,1126,141,18,1285
21/7/2020,八,中國客運碼頭,入境,0,0,0,0
21/7/2020,八,中國客運碼頭,出境,0,0,0,0
21/7/2020,八,港口管制,入境,0,0,0,0
21/7/2020,八,港口管制,出境,0,0,0,0
21/7/2020,八,啟德郵輪碼頭,入境,0,0,0,0
21/7/2020,八,啟德郵輪碼頭,出境,0,0,0,0
21/7/2020,八,港澳客輪碼頭,入境,0,0,0,0
21/7/2020,八,港澳客輪碼頭,出境,0,0,0,0
21/7/2020,八,屯門客運碼頭,入境,0,0,0,0
21/7/2020,八,屯門客運碼頭,出境,0,0,0,0
22/7/2020,八,機場,入境,1089,3,47,1139
22/7/2020,八,機場,出境,1064,41,68,1173
22/7/2020,八,高鐵西九龍,入境,0,0,0,0
22/7/2020,八,高鐵西九龍,出境,0,0,0,0
22/7/2020,八,紅磡,入境,0,0,0,0
22/7/2020,八,紅磡,出境,0,0,0,0
22/7/2020,八,羅湖,入境,0,0,0,0
22/7/2020,八,羅湖,出境,0,0,0,0
22/7/2020,八,落馬洲支線,入境,0,0,0,0
22/7/2020,八,落馬洲支線,出境,0,0,0,0
22/7/2020,八,港珠澳大橋,入境,47,1,5,53
22/7/2020,八,港珠澳大橋,出境,279,26,5,310
22/7/2020,八,落馬洲,入境,0,0,0,0
22/7/2020,八,落馬洲,出境,0,0,0,0
22/7/2020,八,文錦渡,入境,0,0,0,0
22/7/2020,八,文錦渡,出境,0,0,0,0
22/7/2020,八,沙頭角,入境,0,0,0,0
22/7/2020,八,沙頭角,出境,0,0,0,0
22/7/2020,八,深圳灣,入境,326,46,6,378
22/7/2020,八,深圳灣,出境,1702,215,10,1927
22/7/2020,八,中國客運碼頭,入境,0,0,0,0
22/7/2020,八,中國客運碼頭,出境,0,0,0,0
22/7/2020,八,港口管制,入境,0,0,0,0
22/7/2020,八,港口管制,出境,0,0,0,0
22/7/2020,八,啟德郵輪碼頭,入境,0,0,0,0
22/7/2020,八,啟德郵輪碼頭,出境,0,0,0,0
22/7/2020,八,港澳客輪碼頭,入境,0,0,0,0
22/7/2020,八,港澳客輪碼頭,出境,0,0,0,0
22/7/2020,八,屯門客運碼頭,入境,0,0,0,0
22/7/2020,八,屯門客運碼頭,出境,0,0,0,0
23/7/2020,八,機場,入境,453,5,11,469
23/7/2020,八,機場,出境,1165,32,195,1392
23/7/2020,八,高鐵西九龍,入境,0,0,0,0
23/7/2020,八,高鐵西九龍,出境,0,0,0,0
23/7/2020,八,紅磡,入境,0,0,0,0
23/7/2020,八,紅磡,出境,0,0,0,0
23/7/2020,八,羅湖,入境,0,0,0,0
23/7/2020,八,羅湖,出境,0,0,0,0
23/7/2020,八,落馬洲支線,入境,0,0,0,0
23/7/2020,八,落馬洲支線,出境,0,0,0,0
23/7/2020,八,港珠澳大橋,入境,37,1,8,46
23/7/2020,八,港珠澳大橋,出境,252,20,5,277
23/7/2020,八,落馬洲,入境,0,0,0,0
23/7/2020,八,落馬洲,出境,0,0,0,0
23/7/2020,八,文錦渡,入境,0,0,0,0
23/7/2020,八,文錦渡,出境,0,0,0,0
23/7/2020,八,沙頭角,入境,0,0,0,0
23/7/2020,八,沙頭角,出境,0,0,0,0
23/7/2020,八,深圳灣,入境,301,37,20,358
23/7/2020,八,深圳灣,出境,1590,210,16,1816
23/7/2020,八,中國客運碼頭,入境,0,0,0,0
23/7/2020,八,中國客運碼頭,出境,0,0,0,0
23/7/2020,八,港口管制,入境,0,0,0,0
23/7/2020,八,港口管制,出境,0,0,0,0
23/7/2020,八,啟德郵輪碼頭,入境,0,0,0,0
23/7/2020,八,啟德郵輪碼頭,出境,0,0,0,0
23/7/2020,八,港澳客輪碼頭,入境,0,0,0,0
23/7/2020,八,港澳客輪碼頭,出境,0,0,0,0
23/7/2020,八,屯門客運碼頭,入境,0,0,0,0
23/7/2020,八,屯門客運碼頭,出境,0,0,0,0
24/7/2020,八,機場,入境,1069,5,42,1116
24/7/2020,八,機場,出境,1386,56,101,1543
24/7/2020,八,高鐵西九龍,入境,0,0,0,0
24/7/2020,八,高鐵西九龍,出境,0,0,0,0
24/7/2020,八,紅磡,入境,0,0,0,0
24/7/2020,八,紅磡,出境,0,0,0,0
24/7/2020,八,羅湖,入境,0,0,0,0
24/7/2020,八,羅湖,出境,0,0,0,0
24/7/2020,八,落馬洲支線,入境,0,0,0,0
24/7/2020,八,落馬洲支線,出境,0,0,0,0
24/7/2020,八,港珠澳大橋,入境,36,0,2,38
24/7/2020,八,港珠澳大橋,出境,250,18,13,281
24/7/2020,八,落馬洲,入境,0,0,0,0
24/7/2020,八,落馬洲,出境,0,0,0,0
24/7/2020,八,文錦渡,入境,0,0,0,0
24/7/2020,八,文錦渡,出境,0,0,0,0
24/7/2020,八,沙頭角,入境,0,0,0,0
24/7/2020,八,沙頭角,出境,0,0,0,0
24/7/2020,八,深圳灣,入境,277,48,0,325
24/7/2020,八,深圳灣,出境,1853,234,16,2103
24/7/2020,八,中國客運碼頭,入境,0,0,0,0
24/7/2020,八,中國客運碼頭,出境,0,0,0,0
24/7/2020,八,港口管制,入境,0,0,0,0
24/7/2020,八,港口管制,出境,0,0,0,0
24/7/2020,八,啟德郵輪碼頭,入境,0,0,0,0
24/7/2020,八,啟德郵輪碼頭,出境,0,0,0,0
24/7/2020,八,港澳客輪碼頭,入境,0,0,0,0
24/7/2020,八,港澳客輪碼頭,出境,0,0,0,0
24/7/2020,八,屯門客運碼頭,入境,0,0,0,0
24/7/2020,八,屯門客運碼頭,出境,0,0,0,0
25/7/2020,八,機場,入境,577,6,21,604
25/7/2020,八,機場,出境,1280,68,55,1403
25/7/2020,八,高鐵西九龍,入境,0,0,0,0
25/7/2020,八,高鐵西九龍,出境,0,0,0,0
25/7/2020,八,紅磡,入境,0,0,0,0
25/7/2020,八,紅磡,出境,0,0,0,0
25/7/2020,八,羅湖,入境,0,0,0,0
25/7/2020,八,羅湖,出境,0,0,0,0
25/7/2020,八,落馬洲支線,入境,0,0,0,0
25/7/2020,八,落馬洲支線,出境,0,0,0,0
25/7/2020,八,港珠澳大橋,入境,29,2,1,32
25/7/2020,八,港珠澳大橋,出境,252,17,4,273
25/7/2020,八,落馬洲,入境,0,0,0,0
25/7/2020,八,落馬洲,出境,0,0,0,0
25/7/2020,八,文錦渡,入境,0,0,0,0
25/7/2020,八,文錦渡,出境,0,0,0,0
25/7/2020,八,沙頭角,入境,0,0,0,0
25/7/2020,八,沙頭角,出境,0,0,0,0
25/7/2020,八,深圳灣,入境,300,51,5,356
25/7/2020,八,深圳灣,出境,1945,256,6,2207
25/7/2020,八,中國客運碼頭,入境,0,0,0,0
25/7/2020,八,中國客運碼頭,出境,0,0,0,0
25/7/2020,八,港口管制,入境,0,0,0,0
25/7/2020,八,港口管制,出境,0,0,0,0
25/7/2020,八,啟德郵輪碼頭,入境,0,0,0,0
25/7/2020,八,啟德郵輪碼頭,出境,0,0,0,0
25/7/2020,八,港澳客輪碼頭,入境,0,0,0,0
25/7/2020,八,港澳客輪碼頭,出境,0,0,0,0
25/7/2020,八,屯門客運碼頭,入境,0,0,0,0
25/7/2020,八,屯門客運碼頭,出境,0,0,0,0
26/7/2020,八,機場,入境,759,4,49,812
26/7/2020,八,機場,出境,1653,85,73,1811
26/7/2020,八,高鐵西九龍,入境,0,0,0,0
26/7/2020,八,高鐵西九龍,出境,0,0,0,0
26/7/2020,八,紅磡,入境,0,0,0,0
26/7/2020,八,紅磡,出境,0,0,0,0
26/7/2020,八,羅湖,入境,0,0,0,0
26/7/2020,八,羅湖,出境,0,0,0,0
26/7/2020,八,落馬洲支線,入境,0,0,0,0
26/7/2020,八,落馬洲支線,出境,0,0,0,0
26/7/2020,八,港珠澳大橋,入境,14,1,6,21
26/7/2020,八,港珠澳大橋,出境,244,20,4,268
26/7/2020,八,落馬洲,入境,0,0,0,0
26/7/2020,八,落馬洲,出境,0,0,0,0
26/7/2020,八,文錦渡,入境,0,0,0,0
26/7/2020,八,文錦渡,出境,0,0,0,0
26/7/2020,八,沙頭角,入境,0,0,0,0
26/7/2020,八,沙頭角,出境,0,0,0,0
26/7/2020,八,深圳灣,入境,280,33,8,321
26/7/2020,八,深圳灣,出境,999,113,7,1119
26/7/2020,八,中國客運碼頭,入境,0,0,0,0
26/7/2020,八,中國客運碼頭,出境,0,0,0,0
26/7/2020,八,港口管制,入境,0,0,0,0
26/7/2020,八,港口管制,出境,0,0,0,0
26/7/2020,八,啟德郵輪碼頭,入境,0,0,0,0
26/7/2020,八,啟德郵輪碼頭,出境,0,0,0,0
26/7/2020,八,港澳客輪碼頭,入境,0,0,0,0
26/7/2020,八,港澳客輪碼頭,出境,0,0,0,0
26/7/2020,八,屯門客運碼頭,入境,0,0,0,0
26/7/2020,八,屯門客運碼頭,出境,0,0,0,0
27/7/2020,八,機場,入境,517,5,25,547
27/7/2020,八,機場,出境,575,33,42,650
27/7/2020,八,高鐵西九龍,入境,0,0,0,0
27/7/2020,八,高鐵西九龍,出境,0,0,0,0
27/7/2020,八,紅磡,入境,0,0,0,0
27/7/2020,八,紅磡,出境,0,0,0,0
27/7/2020,八,羅湖,入境,0,0,0,0
27/7/2020,八,羅湖,出境,0,0,0,0
27/7/2020,八,落馬洲支線,入境,0,0,0,0
27/7/2020,八,落馬洲支線,出境,0,0,0,0
27/7/2020,八,港珠澳大橋,入境,21,3,4,28
27/7/2020,八,港珠澳大橋,出境,117,3,7,127
27/7/2020,八,落馬洲,入境,0,0,0,0
27/7/2020,八,落馬洲,出境,0,0,0,0
27/7/2020,八,文錦渡,入境,0,0,0,0
27/7/2020,八,文錦渡,出境,0,0,0,0
27/7/2020,八,沙頭角,入境,0,0,0,0
27/7/2020,八,沙頭角,出境,0,0,0,0
27/7/2020,八,深圳灣,入境,286,35,6,327
27/7/2020,八,深圳灣,出境,578,86,5,669
27/7/2020,八,中國客運碼頭,入境,0,0,0,0
27/7/2020,八,中國客運碼頭,出境,0,0,0,0
27/7/2020,八,港口管制,入境,0,0,0,0
27/7/2020,八,港口管制,出境,0,0,0,0
27/7/2020,八,啟德郵輪碼頭,入境,0,0,0,0
27/7/2020,八,啟德郵輪碼頭,出境,0,0,0,0
27/7/2020,八,港澳客輪碼頭,入境,0,0,0,0
27/7/2020,八,港澳客輪碼頭,出境,0,0,0,0
27/7/2020,八,屯門客運碼頭,入境,0,0,0,0
27/7/2020,八,屯門客運碼頭,出境,0,0,0,0
28/7/2020,八,機場,入境,869,10,47,926
28/7/2020,八,機場,出境,1379,62,84,1525
28/7/2020,八,高鐵西九龍,入境,0,0,0,0
28/7/2020,八,高鐵西九龍,出境,0,0,0,0
28/7/2020,八,紅磡,入境,0,0,0,0
28/7/2020,八,紅磡,出境,0,0,0,0
28/7/2020,八,羅湖,入境,0,0,0,0
28/7/2020,八,羅湖,出境,0,0,0,0
28/7/2020,八,落馬洲支線,入境,0,0,0,0
28/7/2020,八,落馬洲支線,出境,0,0,0,0
28/7/2020,八,港珠澳大橋,入境,21,0,8,29
28/7/2020,八,港珠澳大橋,出境,222,12,1,235
28/7/2020,八,落馬洲,入境,0,0,0,0
28/7/2020,八,落馬洲,出境,0,0,0,0
28/7/2020,八,文錦渡,入境,0,0,0,0
28/7/2020,八,文錦渡,出境,0,0,0,0
28/7/2020,八,沙頭角,入境,0,0,0,0
28/7/2020,八,沙頭角,出境,0,0,0,0
28/7/2020,八,深圳灣,入境,281,37,9,327
28/7/2020,八,深圳灣,出境,1098,125,6,1229
28/7/2020,八,中國客運碼頭,入境,0,0,0,0
28/7/2020,八,中國客運碼頭,出境,0,0,0,0
28/7/2020,八,港口管制,入境,0,0,0,0
28/7/2020,八,港口管制,出境,0,0,0,0
28/7/2020,八,啟德郵輪碼頭,入境,0,0,0,0
28/7/2020,八,啟德郵輪碼頭,出境,0,0,0,0
28/7/2020,八,港澳客輪碼頭,入境,0,0,0,0
28/7/2020,八,港澳客輪碼頭,出境,0,0,0,0
28/7/2020,八,屯門客運碼頭,入境,0,0,0,0
28/7/2020,八,屯門客運碼頭,出境,0,0,0,0
29/7/2020,八,機場,入境,333,0,23,356
29/7/2020,八,機場,出境,1143,28,53,1224
29/7/2020,八,高鐵西九龍,入境,0,0,0,0
29/7/2020,八,高鐵西九龍,出境,0,0,0,0
29/7/2020,八,紅磡,入境,0,0,0,0
29/7/2020,八,紅磡,出境,0,0,0,0
29/7/2020,八,羅湖,入境,0,0,0,0
29/7/2020,八,羅湖,出境,0,0,0,0
29/7/2020,八,落馬洲支線,入境,0,0,0,0
29/7/2020,八,落馬洲支線,出境,0,0,0,0
29/7/2020,八,港珠澳大橋,入境,36,0,7,43
29/7/2020,八,港珠澳大橋,出境,291,16,6,313
29/7/2020,八,落馬洲,入境,0,0,0,0
29/7/2020,八,落馬洲,出境,0,0,0,0
29/7/2020,八,文錦渡,入境,0,0,0,0
29/7/2020,八,文錦渡,出境,0,0,0,0
29/7/2020,八,沙頭角,入境,0,0,0,0
29/7/2020,八,沙頭角,出境,0,0,0,0
29/7/2020,八,深圳灣,入境,306,25,4,335
29/7/2020,八,深圳灣,出境,2295,267,14,2576
29/7/2020,八,中國客運碼頭,入境,0,0,0,0
29/7/2020,八,中國客運碼頭,出境,0,0,0,0
29/7/2020,八,港口管制,入境,0,0,0,0
29/7/2020,八,港口管制,出境,0,0,0,0
29/7/2020,八,啟德郵輪碼頭,入境,0,0,0,0
29/7/2020,八,啟德郵輪碼頭,出境,0,0,0,0
29/7/2020,八,港澳客輪碼頭,入境,0,0,0,0
29/7/2020,八,港澳客輪碼頭,出境,0,0,0,0
29/7/2020,八,屯門客運碼頭,入境,0,0,0,0
29/7/2020,八,屯門客運碼頭,出境,0,0,0,0
30/7/2020,八,機場,入境,250,3,20,273
30/7/2020,八,機場,出境,779,23,36,838
30/7/2020,八,高鐵西九龍,入境,0,0,0,0
30/7/2020,八,高鐵西九龍,出境,0,0,0,0
30/7/2020,八,紅磡,入境,0,0,0,0
30/7/2020,八,紅磡,出境,0,0,0,0
30/7/2020,八,羅湖,入境,0,0,0,0
30/7/2020,八,羅湖,出境,0,0,0,0
30/7/2020,八,落馬洲支線,入境,0,0,0,0
30/7/2020,八,落馬洲支線,出境,0,0,0,0
30/7/2020,八,港珠澳大橋,入境,39,2,1,42
30/7/2020,八,港珠澳大橋,出境,321,20,9,350
30/7/2020,八,落馬洲,入境,0,0,0,0
30/7/2020,八,落馬洲,出境,0,0,0,0
30/7/2020,八,文錦渡,入境,0,0,0,0
30/7/2020,八,文錦渡,出境,0,0,0,0
30/7/2020,八,沙頭角,入境,0,0,0,0
30/7/2020,八,沙頭角,出境,0,0,0,0
30/7/2020,八,深圳灣,入境,309,36,3,348
30/7/2020,八,深圳灣,出境,1941,228,3,2172
30/7/2020,八,中國客運碼頭,入境,0,0,0,0
30/7/2020,八,中國客運碼頭,出境,0,0,0,0
30/7/2020,八,港口管制,入境,0,0,0,0
30/7/2020,八,港口管制,出境,0,0,0,0
30/7/2020,八,啟德郵輪碼頭,入境,0,0,0,0
30/7/2020,八,啟德郵輪碼頭,出境,0,0,0,0
30/7/2020,八,港澳客輪碼頭,入境,0,0,0,0
30/7/2020,八,港澳客輪碼頭,出境,0,0,0,0
30/7/2020,八,屯門客運碼頭,入境,0,0,0,0
30/7/2020,八,屯門客運碼頭,出境,0,0,0,0
31/7/2020,八,機場,入境,568,3,65,636
31/7/2020,八,機場,出境,1681,57,98,1836
31/7/2020,八,高鐵西九龍,入境,0,0,0,0
31/7/2020,八,高鐵西九龍,出境,0,0,0,0
31/7/2020,八,紅磡,入境,0,0,0,0
31/7/2020,八,紅磡,出境,0,0,0,0
31/7/2020,八,羅湖,入境,0,0,0,0
31/7/2020,八,羅湖,出境,0,0,0,0
31/7/2020,八,落馬洲支線,入境,0,0,0,0
31/7/2020,八,落馬洲支線,出境,0,0,0,0
31/7/2020,八,港珠澳大橋,入境,56,1,4,61
31/7/2020,八,港珠澳大橋,出境,288,14,5,307
31/7/2020,八,落馬洲,入境,0,0,0,0
31/7/2020,八,落馬洲,出境,0,0,0,0
31/7/2020,八,文錦渡,入境,0,0,0,0
31/7/2020,八,文錦渡,出境,0,0,0,0
31/7/2020,八,沙頭角,入境,0,0,0,0
31/7/2020,八,沙頭角,出境,0,0,0,0
31/7/2020,八,深圳灣,入境,359,39,4,402
31/7/2020,八,深圳灣,出境,2336,301,4,2641
31/7/2020,八,中國客運碼頭,入境,0,0,0,0
31/7/2020,八,中國客運碼頭,出境,0,0,0,0
31/7/2020,八,港口管制,入境,0,0,0,0
31/7/2020,八,港口管制,出境,0,0,0,0
31/7/2020,八,啟德郵輪碼頭,入境,0,0,0,0
31/7/2020,八,啟德郵輪碼頭,出境,0,0,0,0
31/7/2020,八,港澳客輪碼頭,入境,0,0,0,0
31/7/2020,八,港澳客輪碼頭,出境,0,0,0,0
31/7/2020,八,屯門客運碼頭,入境,0,0,0,0
31/7/2020,八,屯門客運碼頭,出境,0,0,0,0
1/8/2020,八,機場,入境,571,5,11,587
1/8/2020,八,機場,出境,1800,80,82,1962
1/8/2020,八,高鐵西九龍,入境,0,0,0,0
1/8/2020,八,高鐵西九龍,出境,0,0,0,0
1/8/2020,八,紅磡,入境,0,0,0,0
1/8/2020,八,紅磡,出境,0,0,0,0
1/8/2020,八,羅湖,入境,0,0,0,0
1/8/2020,八,羅湖,出境,0,0,0,0
1/8/2020,八,落馬洲支線,入境,0,0,0,0
1/8/2020,八,落馬洲支線,出境,0,0,0,0
1/8/2020,八,港珠澳大橋,入境,29,1,4,34
1/8/2020,八,港珠澳大橋,出境,242,21,4,267
1/8/2020,八,落馬洲,入境,0,0,0,0
1/8/2020,八,落馬洲,出境,0,0,0,0
1/8/2020,八,文錦渡,入境,0,0,0,0
1/8/2020,八,文錦渡,出境,0,0,0,0
1/8/2020,八,沙頭角,入境,0,0,0,0
1/8/2020,八,沙頭角,出境,0,0,0,0
1/8/2020,八,深圳灣,入境,350,50,4,404
1/8/2020,八,深圳灣,出境,1861,219,10,2090
1/8/2020,八,中國客運碼頭,入境,0,0,0,0
1/8/2020,八,中國客運碼頭,出境,0,0,0,0
1/8/2020,八,港口管制,入境,0,0,0,0
1/8/2020,八,港口管制,出境,0,0,0,0
1/8/2020,八,啟德郵輪碼頭,入境,0,0,0,0
1/8/2020,八,啟德郵輪碼頭,出境,0,0,0,0
1/8/2020,八,港澳客輪碼頭,入境,0,0,0,0
1/8/2020,八,港澳客輪碼頭,出境,0,0,0,0
1/8/2020,八,屯門客運碼頭,入境,0,0,0,0
1/8/2020,八,屯門客運碼頭,出境,0,0,0,0
2/8/2020,八,機場,入境,674,3,46,723
2/8/2020,八,機場,出境,1663,59,96,1818
2/8/2020,八,高鐵西九龍,入境,0,0,0,0
2/8/2020,八,高鐵西九龍,出境,0,0,0,0
2/8/2020,八,紅磡,入境,0,0,0,0
2/8/2020,八,紅磡,出境,0,0,0,0
2/8/2020,八,羅湖,入境,0,0,0,0
2/8/2020,八,羅湖,出境,0,0,0,0
2/8/2020,八,落馬洲支線,入境,0,0,0,0
2/8/2020,八,落馬洲支線,出境,0,0,0,0
2/8/2020,八,港珠澳大橋,入境,32,2,8,42
2/8/2020,八,港珠澳大橋,出境,233,19,0,252
2/8/2020,八,落馬洲,入境,0,0,0,0
2/8/2020,八,落馬洲,出境,0,0,0,0
2/8/2020,八,文錦渡,入境,0,0,0,0
2/8/2020,八,文錦渡,出境,0,0,0,0
2/8/2020,八,沙頭角,入境,0,0,0,0
2/8/2020,八,沙頭角,出境,0,0,0,0
2/8/2020,八,深圳灣,入境,338,29,5,372
2/8/2020,八,深圳灣,出境,1032,106,4,1142
2/8/2020,八,中國客運碼頭,入境,0,0,0,0
2/8/2020,八,中國客運碼頭,出境,0,0,0,0
2/8/2020,八,港口管制,入境,0,0,0,0
2/8/2020,八,港口管制,出境,0,0,0,0
2/8/2020,八,啟德郵輪碼頭,入境,0,0,0,0
2/8/2020,八,啟德郵輪碼頭,出境,0,0,0,0
2/8/2020,八,港澳客輪碼頭,入境,0,0,0,0
2/8/2020,八,港澳客輪碼頭,出境,0,0,0,0
2/8/2020,八,屯門客運碼頭,入境,0,0,0,0
2/8/2020,八,屯門客運碼頭,出境,0,0,0,0
3/8/2020,八,機場,入境,416,2,14,432
3/8/2020,八,機場,出境,883,24,112,1019
3/8/2020,八,高鐵西九龍,入境,0,0,0,0
3/8/2020,八,高鐵西九龍,出境,0,0,0,0
3/8/2020,八,紅磡,入境,0,0,0,0
3/8/2020,八,紅磡,出境,0,0,0,0
3/8/2020,八,羅湖,入境,0,0,0,0
3/8/2020,八,羅湖,出境,0,0,0,0
3/8/2020,八,落馬洲支線,入境,0,0,0,0
3/8/2020,八,落馬洲支線,出境,0,0,0,0
3/8/2020,八,港珠澳大橋,入境,28,4,11,43
3/8/2020,八,港珠澳大橋,出境,157,4,2,163
3/8/2020,八,落馬洲,入境,0,0,0,0
3/8/2020,八,落馬洲,出境,0,0,0,0
3/8/2020,八,文錦渡,入境,0,0,0,0
3/8/2020,八,文錦渡,出境,0,0,0,0
3/8/2020,八,沙頭角,入境,0,0,0,0
3/8/2020,八,沙頭角,出境,0,0,0,0
3/8/2020,八,深圳灣,入境,428,22,9,459
3/8/2020,八,深圳灣,出境,498,61,1,560
3/8/2020,八,中國客運碼頭,入境,0,0,0,0
3/8/2020,八,中國客運碼頭,出境,0,0,0,0
3/8/2020,八,港口管制,入境,0,0,0,0
3/8/2020,八,港口管制,出境,0,0,0,0
3/8/2020,八,啟德郵輪碼頭,入境,0,0,0,0
3/8/2020,八,啟德郵輪碼頭,出境,0,0,0,0
3/8/2020,八,港澳客輪碼頭,入境,0,0,0,0
3/8/2020,八,港澳客輪碼頭,出境,0,0,0,0
3/8/2020,八,屯門客運碼頭,入境,0,0,0,0
3/8/2020,八,屯門客運碼頭,出境,0,0,0,0
4/8/2020,八,機場,入境,693,3,34,730
4/8/2020,八,機場,出境,1440,61,91,1592
4/8/2020,八,高鐵西九龍,入境,0,0,0,0
4/8/2020,八,高鐵西九龍,出境,0,0,0,0
4/8/2020,八,紅磡,入境,0,0,0,0
4/8/2020,八,紅磡,出境,0,0,0,0
4/8/2020,八,羅湖,入境,0,0,0,0
4/8/2020,八,羅湖,出境,0,0,0,0
4/8/2020,八,落馬洲支線,入境,0,0,0,0
4/8/2020,八,落馬洲支線,出境,0,0,0,0
4/8/2020,八,港珠澳大橋,入境,29,2,5,36
4/8/2020,八,港珠澳大橋,出境,188,21,7,216
4/8/2020,八,落馬洲,入境,0,0,0,0
4/8/2020,八,落馬洲,出境,0,0,0,0
4/8/2020,八,文錦渡,入境,0,0,0,0
4/8/2020,八,文錦渡,出境,0,0,0,0
4/8/2020,八,沙頭角,入境,0,0,0,0
4/8/2020,八,沙頭角,出境,0,0,0,0
4/8/2020,八,深圳灣,入境,312,30,6,348
4/8/2020,八,深圳灣,出境,939,103,6,1048
4/8/2020,八,中國客運碼頭,入境,0,0,0,0
4/8/2020,八,中國客運碼頭,出境,0,0,0,0
4/8/2020,八,港口管制,入境,0,0,0,0
4/8/2020,八,港口管制,出境,0,0,0,0
4/8/2020,八,啟德郵輪碼頭,入境,0,0,0,0
4/8/2020,八,啟德郵輪碼頭,出境,0,0,0,0
4/8/2020,八,港澳客輪碼頭,入境,0,0,0,0
4/8/2020,八,港澳客輪碼頭,出境,0,0,0,0
4/8/2020,八,屯門客運碼頭,入境,0,0,0,0
4/8/2020,八,屯門客運碼頭,出境,0,0,0,0
5/8/2020,八,機場,入境,683,3,40,726
5/8/2020,八,機場,出境,857,27,42,926
5/8/2020,八,高鐵西九龍,入境,0,0,0,0
5/8/2020,八,高鐵西九龍,出境,0,0,0,0
5/8/2020,八,紅磡,入境,0,0,0,0
5/8/2020,八,紅磡,出境,0,0,0,0
5/8/2020,八,羅湖,入境,0,0,0,0
5/8/2020,八,羅湖,出境,0,0,0,0
5/8/2020,八,落馬洲支線,入境,0,0,0,0
5/8/2020,八,落馬洲支線,出境,0,0,0,0
5/8/2020,八,港珠澳大橋,入境,31,0,8,39
5/8/2020,八,港珠澳大橋,出境,255,14,10,279
5/8/2020,八,落馬洲,入境,0,0,0,0
5/8/2020,八,落馬洲,出境,0,0,0,0
5/8/2020,八,文錦渡,入境,0,0,0,0
5/8/2020,八,文錦渡,出境,0,0,0,0
5/8/2020,八,沙頭角,入境,0,0,0,0
5/8/2020,八,沙頭角,出境,0,0,0,0
5/8/2020,八,深圳灣,入境,301,29,6,336
5/8/2020,八,深圳灣,出境,1832,226,6,2064
5/8/2020,八,中國客運碼頭,入境,0,0,0,0
5/8/2020,八,中國客運碼頭,出境,0,0,0,0
5/8/2020,八,港口管制,入境,0,0,0,0
5/8/2020,八,港口管制,出境,0,0,0,0
5/8/2020,八,啟德郵輪碼頭,入境,0,0,0,0
5/8/2020,八,啟德郵輪碼頭,出境,0,0,0,0
5/8/2020,八,港澳客輪碼頭,入境,0,0,0,0
5/8/2020,八,港澳客輪碼頭,出境,0,0,0,0
5/8/2020,八,屯門客運碼頭,入境,0,0,0,0
5/8/2020,八,屯門客運碼頭,出境,0,0,0,0
6/8/2020,八,機場,入境,373,3,20,396
6/8/2020,八,機場,出境,1195,32,99,1326
6/8/2020,八,高鐵西九龍,入境,0,0,0,0
6/8/2020,八,高鐵西九龍,出境,0,0,0,0
6/8/2020,八,紅磡,入境,0,0,0,0
6/8/2020,八,紅磡,出境,0,0,0,0
6/8/2020,八,羅湖,入境,0,0,0,0
6/8/2020,八,羅湖,出境,0,0,0,0
6/8/2020,八,落馬洲支線,入境,0,0,0,0
6/8/2020,八,落馬洲支線,出境,0,0,0,0
6/8/2020,八,港珠澳大橋,入境,41,2,5,48
6/8/2020,八,港珠澳大橋,出境,284,14,7,305
6/8/2020,八,落馬洲,入境,0,0,0,0
6/8/2020,八,落馬洲,出境,0,0,0,0
6/8/2020,八,文錦渡,入境,0,0,0,0
6/8/2020,八,文錦渡,出境,0,0,0,0
6/8/2020,八,沙頭角,入境,0,0,0,0
6/8/2020,八,沙頭角,出境,0,0,0,0
6/8/2020,八,深圳灣,入境,347,37,2,386
6/8/2020,八,深圳灣,出境,2262,302,5,2569
6/8/2020,八,中國客運碼頭,入境,0,0,0,0
6/8/2020,八,中國客運碼頭,出境,0,0,0,0
6/8/2020,八,港口管制,入境,0,0,0,0
6/8/2020,八,港口管制,出境,0,0,0,0
6/8/2020,八,啟德郵輪碼頭,入境,0,0,0,0
6/8/2020,八,啟德郵輪碼頭,出境,0,0,0,0
6/8/2020,八,港澳客輪碼頭,入境,0,0,0,0
6/8/2020,八,港澳客輪碼頭,出境,0,0,0,0
6/8/2020,八,屯門客運碼頭,入境,0,0,0,0
6/8/2020,八,屯門客運碼頭,出境,0,0,0,0
7/8/2020,八,機場,入境,672,5,46,723
7/8/2020,八,機場,出境,1312,32,117,1461
7/8/2020,八,高鐵西九龍,入境,0,0,0,0
7/8/2020,八,高鐵西九龍,出境,0,0,0,0
7/8/2020,八,紅磡,入境,0,0,0,0
7/8/2020,八,紅磡,出境,0,0,0,0
7/8/2020,八,羅湖,入境,0,0,0,0
7/8/2020,八,羅湖,出境,0,0,0,0
7/8/2020,八,落馬洲支線,入境,0,0,0,0
7/8/2020,八,落馬洲支線,出境,0,0,0,0
7/8/2020,八,港珠澳大橋,入境,26,1,10,37
7/8/2020,八,港珠澳大橋,出境,149,12,8,169
7/8/2020,八,落馬洲,入境,0,0,0,0
7/8/2020,八,落馬洲,出境,0,0,0,0
7/8/2020,八,文錦渡,入境,0,0,0,0
7/8/2020,八,文錦渡,出境,0,0,0,0
7/8/2020,八,沙頭角,入境,0,0,0,0
7/8/2020,八,沙頭角,出境,0,0,0,0
7/8/2020,八,深圳灣,入境,411,32,6,449
7/8/2020,八,深圳灣,出境,931,108,2,1041
7/8/2020,八,中國客運碼頭,入境,0,0,0,0
7/8/2020,八,中國客運碼頭,出境,0,0,0,0
7/8/2020,八,港口管制,入境,0,0,0,0
7/8/2020,八,港口管制,出境,0,0,0,0
7/8/2020,八,啟德郵輪碼頭,入境,0,0,0,0
7/8/2020,八,啟德郵輪碼頭,出境,0,0,0,0
7/8/2020,八,港澳客輪碼頭,入境,0,0,0,0
7/8/2020,八,港澳客輪碼頭,出境,0,0,0,0
7/8/2020,八,屯門客運碼頭,入境,0,0,0,0
7/8/2020,八,屯門客運碼頭,出境,0,0,0,0
8/8/2020,八,機場,入境,646,5,22,673
8/8/2020,八,機場,出境,1594,65,56,1715
8/8/2020,八,高鐵西九龍,入境,0,0,0,0
8/8/2020,八,高鐵西九龍,出境,0,0,0,0
8/8/2020,八,紅磡,入境,0,0,0,0
8/8/2020,八,紅磡,出境,0,0,0,0
8/8/2020,八,羅湖,入境,0,0,0,0
8/8/2020,八,羅湖,出境,0,0,0,0
8/8/2020,八,落馬洲支線,入境,0,0,0,0
8/8/2020,八,落馬洲支線,出境,0,0,0,0
8/8/2020,八,港珠澳大橋,入境,38,3,5,46
8/8/2020,八,港珠澳大橋,出境,181,15,4,200
8/8/2020,八,落馬洲,入境,0,0,0,0
8/8/2020,八,落馬洲,出境,0,0,0,0
8/8/2020,八,文錦渡,入境,0,0,0,0
8/8/2020,八,文錦渡,出境,0,0,0,0
8/8/2020,八,沙頭角,入境,0,0,0,0
8/8/2020,八,沙頭角,出境,0,0,0,0
8/8/2020,八,深圳灣,入境,370,51,7,428
8/8/2020,八,深圳灣,出境,852,105,1,958
8/8/2020,八,中國客運碼頭,入境,0,0,0,0
8/8/2020,八,中國客運碼頭,出境,0,0,0,0
8/8/2020,八,港口管制,入境,0,0,0,0
8/8/2020,八,港口管制,出境,0,0,0,0
8/8/2020,八,啟德郵輪碼頭,入境,0,0,0,0
8/8/2020,八,啟德郵輪碼頭,出境,0,0,0,0
8/8/2020,八,港澳客輪碼頭,入境,0,0,0,0
8/8/2020,八,港澳客輪碼頭,出境,0,0,0,0
8/8/2020,八,屯門客運碼頭,入境,0,0,0,0
8/8/2020,八,屯門客運碼頭,出境,0,0,0,0
9/8/2020,八,機場,入境,621,10,28,659
9/8/2020,八,機場,出境,1522,47,84,1653
9/8/2020,八,高鐵西九龍,入境,0,0,0,0
9/8/2020,八,高鐵西九龍,出境,0,0,0,0
9/8/2020,八,紅磡,入境,0,0,0,0
9/8/2020,八,紅磡,出境,0,0,0,0
9/8/2020,八,羅湖,入境,0,0,0,0
9/8/2020,八,羅湖,出境,0,0,0,0
9/8/2020,八,落馬洲支線,入境,0,0,0,0
9/8/2020,八,落馬洲支線,出境,0,0,0,0
9/8/2020,八,港珠澳大橋,入境,42,4,6,52
9/8/2020,八,港珠澳大橋,出境,113,6,3,122
9/8/2020,八,落馬洲,入境,0,0,0,0
9/8/2020,八,落馬洲,出境,0,0,0,0
9/8/2020,八,文錦渡,入境,0,0,0,0
9/8/2020,八,文錦渡,出境,0,0,0,0
9/8/2020,八,沙頭角,入境,0,0,0,0
9/8/2020,八,沙頭角,出境,0,0,0,0
9/8/2020,八,深圳灣,入境,415,37,1,453
9/8/2020,八,深圳灣,出境,646,78,2,726
9/8/2020,八,中國客運碼頭,入境,0,0,0,0
9/8/2020,八,中國客運碼頭,出境,0,0,0,0
9/8/2020,八,港口管制,入境,0,0,0,0
9/8/2020,八,港口管制,出境,0,0,0,0
9/8/2020,八,啟德郵輪碼頭,入境,0,0,0,0
9/8/2020,八,啟德郵輪碼頭,出境,0,0,0,0
9/8/2020,八,港澳客輪碼頭,入境,0,0,0,0
9/8/2020,八,港澳客輪碼頭,出境,0,0,0,0
9/8/2020,八,屯門客運碼頭,入境,0,0,0,0
9/8/2020,八,屯門客運碼頭,出境,0,0,0,0
10/8/2020,八,機場,入境,528,10,22,560
10/8/2020,八,機場,出境,749,19,78,846
10/8/2020,八,高鐵西九龍,入境,0,0,0,0
10/8/2020,八,高鐵西九龍,出境,0,0,0,0
10/8/2020,八,紅磡,入境,0,0,0,0
10/8/2020,八,紅磡,出境,0,0,0,0
10/8/2020,八,羅湖,入境,0,0,0,0
10/8/2020,八,羅湖,出境,0,0,0,0
10/8/2020,八,落馬洲支線,入境,0,0,0,0
10/8/2020,八,落馬洲支線,出境,0,0,0,0
10/8/2020,八,港珠澳大橋,入境,33,3,7,43
10/8/2020,八,港珠澳大橋,出境,98,3,4,105
10/8/2020,八,落馬洲,入境,0,0,0,0
10/8/2020,八,落馬洲,出境,0,0,0,0
10/8/2020,八,文錦渡,入境,0,0,0,0
10/8/2020,八,文錦渡,出境,0,0,0,0
10/8/2020,八,沙頭角,入境,0,0,0,0
10/8/2020,八,沙頭角,出境,0,0,0,0
10/8/2020,八,深圳灣,入境,530,43,2,575
10/8/2020,八,深圳灣,出境,500,49,1,550
10/8/2020,八,中國客運碼頭,入境,0,0,0,0
10/8/2020,八,中國客運碼頭,出境,0,0,0,0
10/8/2020,八,港口管制,入境,0,0,0,0
10/8/2020,八,港口管制,出境,0,0,0,0
10/8/2020,八,啟德郵輪碼頭,入境,0,0,0,0
10/8/2020,八,啟德郵輪碼頭,出境,0,0,0,0
10/8/2020,八,港澳客輪碼頭,入境,0,0,0,0
10/8/2020,八,港澳客輪碼頭,出境,0,0,0,0
10/8/2020,八,屯門客運碼頭,入境,0,0,0,0
10/8/2020,八,屯門客運碼頭,出境,0,0,0,0
11/8/2020,八,機場,入境,798,2,33,833
11/8/2020,八,機場,出境,988,23,57,1068
11/8/2020,八,高鐵西九龍,入境,0,0,0,0
11/8/2020,八,高鐵西九龍,出境,0,0,0,0
11/8/2020,八,紅磡,入境,0,0,0,0
11/8/2020,八,紅磡,出境,0,0,0,0
11/8/2020,八,羅湖,入境,0,0,0,0
11/8/2020,八,羅湖,出境,0,0,0,0
11/8/2020,八,落馬洲支線,入境,0,0,0,0
11/8/2020,八,落馬洲支線,出境,0,0,0,0
11/8/2020,八,港珠澳大橋,入境,23,1,2,26
11/8/2020,八,港珠澳大橋,出境,167,4,3,174
11/8/2020,八,落馬洲,入境,0,0,0,0
11/8/2020,八,落馬洲,出境,0,0,0,0
11/8/2020,八,文錦渡,入境,0,0,0,0
11/8/2020,八,文錦渡,出境,0,0,0,0
11/8/2020,八,沙頭角,入境,0,0,0,0
11/8/2020,八,沙頭角,出境,0,0,0,0
11/8/2020,八,深圳灣,入境,383,44,3,430
11/8/2020,八,深圳灣,出境,884,111,4,999
11/8/2020,八,中國客運碼頭,入境,0,0,0,0
11/8/2020,八,中國客運碼頭,出境,0,0,0,0
11/8/2020,八,港口管制,入境,0,0,0,0
11/8/2020,八,港口管制,出境,0,0,0,0
11/8/2020,八,啟德郵輪碼頭,入境,0,0,0,0
11/8/2020,八,啟德郵輪碼頭,出境,0,0,0,0
11/8/2020,八,港澳客輪碼頭,入境,0,0,0,0
11/8/2020,八,港澳客輪碼頭,出境,0,0,0,0
11/8/2020,八,屯門客運碼頭,入境,0,0,0,0
11/8/2020,八,屯門客運碼頭,出境,0,0,0,0
12/8/2020,八,機場,入境,388,7,21,416
12/8/2020,八,機場,出境,922,24,43,989
12/8/2020,八,高鐵西九龍,入境,0,0,0,0
12/8/2020,八,高鐵西九龍,出境,0,0,0,0
12/8/2020,八,紅磡,入境,0,0,0,0
12/8/2020,八,紅磡,出境,0,0,0,0
12/8/2020,八,羅湖,入境,0,0,0,0
12/8/2020,八,羅湖,出境,0,0,0,0
12/8/2020,八,落馬洲支線,入境,0,0,0,0
12/8/2020,八,落馬洲支線,出境,0,0,0,0
12/8/2020,八,港珠澳大橋,入境,40,0,5,45
12/8/2020,八,港珠澳大橋,出境,203,23,3,229
12/8/2020,八,落馬洲,入境,0,0,0,0
12/8/2020,八,落馬洲,出境,0,0,0,0
12/8/2020,八,文錦渡,入境,0,0,0,0
12/8/2020,八,文錦渡,出境,0,0,0,0
12/8/2020,八,沙頭角,入境,0,0,0,0
12/8/2020,八,沙頭角,出境,0,0,0,0
12/8/2020,八,深圳灣,入境,504,51,8,563
12/8/2020,八,深圳灣,出境,1062,169,4,1235
12/8/2020,八,中國客運碼頭,入境,0,0,0,0
12/8/2020,八,中國客運碼頭,出境,0,0,0,0
12/8/2020,八,港口管制,入境,0,0,0,0
12/8/2020,八,港口管制,出境,0,0,0,0
12/8/2020,八,啟德郵輪碼頭,入境,0,0,0,0
12/8/2020,八,啟德郵輪碼頭,出境,0,0,0,0
12/8/2020,八,港澳客輪碼頭,入境,0,0,0,0
12/8/2020,八,港澳客輪碼頭,出境,0,0,0,0
12/8/2020,八,屯門客運碼頭,入境,0,0,0,0
12/8/2020,八,屯門客運碼頭,出境,0,0,0,0
13/8/2020,八,機場,入境,532,2,16,550
13/8/2020,八,機場,出境,1179,15,61,1255
13/8/2020,八,高鐵西九龍,入境,0,0,0,0
13/8/2020,八,高鐵西九龍,出境,0,0,0,0
13/8/2020,八,紅磡,入境,0,0,0,0
13/8/2020,八,紅磡,出境,0,0,0,0
13/8/2020,八,羅湖,入境,0,0,0,0
13/8/2020,八,羅湖,出境,0,0,0,0
13/8/2020,八,落馬洲支線,入境,0,0,0,0
13/8/2020,八,落馬洲支線,出境,0,0,0,0
13/8/2020,八,港珠澳大橋,入境,38,3,6,47
13/8/2020,八,港珠澳大橋,出境,194,10,5,209
13/8/2020,八,落馬洲,入境,0,0,0,0
13/8/2020,八,落馬洲,出境,0,0,0,0
13/8/2020,八,文錦渡,入境,0,0,0,0
13/8/2020,八,文錦渡,出境,0,0,0,0
13/8/2020,八,沙頭角,入境,0,0,0,0
13/8/2020,八,沙頭角,出境,0,0,0,0
13/8/2020,八,深圳灣,入境,571,53,3,627
13/8/2020,八,深圳灣,出境,1035,156,4,1195
13/8/2020,八,中國客運碼頭,入境,0,0,0,0
13/8/2020,八,中國客運碼頭,出境,0,0,0,0
13/8/2020,八,港口管制,入境,0,0,0,0
13/8/2020,八,港口管制,出境,0,0,0,0
13/8/2020,八,啟德郵輪碼頭,入境,0,0,0,0
13/8/2020,八,啟德郵輪碼頭,出境,0,0,0,0
13/8/2020,八,港澳客輪碼頭,入境,0,0,0,0
13/8/2020,八,港澳客輪碼頭,出境,0,0,0,0
13/8/2020,八,屯門客運碼頭,入境,0,0,0,0
13/8/2020,八,屯門客運碼頭,出境,0,0,0,0
14/8/2020,八,機場,入境,793,3,49,845
14/8/2020,八,機場,出境,1565,23,88,1676
14/8/2020,八,高鐵西九龍,入境,0,0,0,0
14/8/2020,八,高鐵西九龍,出境,0,0,0,0
14/8/2020,八,紅磡,入境,0,0,0,0
14/8/2020,八,紅磡,出境,0,0,0,0
14/8/2020,八,羅湖,入境,0,0,0,0
14/8/2020,八,羅湖,出境,0,0,0,0
14/8/2020,八,落馬洲支線,入境,0,0,0,0
14/8/2020,八,落馬洲支線,出境,0,0,0,0
14/8/2020,八,港珠澳大橋,入境,51,1,7,59
14/8/2020,八,港珠澳大橋,出境,188,7,7,202
14/8/2020,八,落馬洲,入境,0,0,0,0
14/8/2020,八,落馬洲,出境,0,0,0,0
14/8/2020,八,文錦渡,入境,0,0,0,0
14/8/2020,八,文錦渡,出境,0,0,0,0
14/8/2020,八,沙頭角,入境,0,0,0,0
14/8/2020,八,沙頭角,出境,0,0,0,0
14/8/2020,八,深圳灣,入境,500,48,2,550
14/8/2020,八,深圳灣,出境,880,85,5,970
14/8/2020,八,中國客運碼頭,入境,0,0,0,0
14/8/2020,八,中國客運碼頭,出境,0,0,0,0
14/8/2020,八,港口管制,入境,0,0,0,0
14/8/2020,八,港口管制,出境,0,0,0,0
14/8/2020,八,啟德郵輪碼頭,入境,0,0,0,0
14/8/2020,八,啟德郵輪碼頭,出境,0,0,0,0
14/8/2020,八,港澳客輪碼頭,入境,0,0,0,0
14/8/2020,八,港澳客輪碼頭,出境,0,0,0,0
14/8/2020,八,屯門客運碼頭,入境,0,0,0,0
14/8/2020,八,屯門客運碼頭,出境,0,0,0,0
15/8/2020,八,機場,入境,745,5,39,789
15/8/2020,八,機場,出境,1636,44,195,1875
15/8/2020,八,高鐵西九龍,入境,0,0,0,0
15/8/2020,八,高鐵西九龍,出境,0,0,0,0
15/8/2020,八,紅磡,入境,0,0,0,0
15/8/2020,八,紅磡,出境,0,0,0,0
15/8/2020,八,羅湖,入境,0,0,0,0
15/8/2020,八,羅湖,出境,0,0,0,0
15/8/2020,八,落馬洲支線,入境,0,0,0,0
15/8/2020,八,落馬洲支線,出境,0,0,0,0
15/8/2020,八,港珠澳大橋,入境,46,9,33,88
15/8/2020,八,港珠澳大橋,出境,152,6,4,162
15/8/2020,八,落馬洲,入境,0,0,0,0
15/8/2020,八,落馬洲,出境,0,0,0,0
15/8/2020,八,文錦渡,入境,0,0,0,0
15/8/2020,八,文錦渡,出境,0,0,0,0
15/8/2020,八,沙頭角,入境,0,0,0,0
15/8/2020,八,沙頭角,出境,0,0,0,0
15/8/2020,八,深圳灣,入境,629,76,6,711
15/8/2020,八,深圳灣,出境,774,108,7,889
15/8/2020,八,中國客運碼頭,入境,0,0,0,0
15/8/2020,八,中國客運碼頭,出境,0,0,0,0
15/8/2020,八,港口管制,入境,0,0,0,0
15/8/2020,八,港口管制,出境,0,0,0,0
15/8/2020,八,啟德郵輪碼頭,入境,0,0,0,0
15/8/2020,八,啟德郵輪碼頭,出境,0,0,0,0
15/8/2020,八,港澳客輪碼頭,入境,0,0,0,0
15/8/2020,八,港澳客輪碼頭,出境,0,0,0,0
15/8/2020,八,屯門客運碼頭,入境,0,0,0,0
15/8/2020,八,屯門客運碼頭,出境,0,0,0,0
16/8/2020,八,機場,入境,786,11,21,818
16/8/2020,八,機場,出境,1595,35,74,1704
16/8/2020,八,高鐵西九龍,入境,0,0,0,0
16/8/2020,八,高鐵西九龍,出境,0,0,0,0
16/8/2020,八,紅磡,入境,0,0,0,0
16/8/2020,八,紅磡,出境,0,0,0,0
16/8/2020,八,羅湖,入境,0,0,0,0
16/8/2020,八,羅湖,出境,0,0,0,0
16/8/2020,八,落馬洲支線,入境,0,0,0,0
16/8/2020,八,落馬洲支線,出境,0,0,0,0
16/8/2020,八,港珠澳大橋,入境,51,3,1,55
16/8/2020,八,港珠澳大橋,出境,113,7,6,126
16/8/2020,八,落馬洲,入境,0,0,0,0
16/8/2020,八,落馬洲,出境,0,0,0,0
16/8/2020,八,文錦渡,入境,0,0,0,0
16/8/2020,八,文錦渡,出境,0,0,0,0
16/8/2020,八,沙頭角,入境,0,0,0,0
16/8/2020,八,沙頭角,出境,0,0,0,0
16/8/2020,八,深圳灣,入境,699,57,6,762
16/8/2020,八,深圳灣,出境,659,69,2,730
16/8/2020,八,中國客運碼頭,入境,0,0,0,0
16/8/2020,八,中國客運碼頭,出境,0,0,0,0
16/8/2020,八,港口管制,入境,0,0,0,0
16/8/2020,八,港口管制,出境,0,0,0,0
16/8/2020,八,啟德郵輪碼頭,入境,0,0,0,0
16/8/2020,八,啟德郵輪碼頭,出境,0,0,0,0
16/8/2020,八,港澳客輪碼頭,入境,0,0,0,0
16/8/2020,八,港澳客輪碼頭,出境,0,0,0,0
16/8/2020,八,屯門客運碼頭,入境,0,0,0,0
16/8/2020,八,屯門客運碼頭,出境,0,0,0,0
17/8/2020,八,機場,入境,690,6,22,718
17/8/2020,八,機場,出境,913,15,32,960
17/8/2020,八,高鐵西九龍,入境,0,0,0,0
17/8/2020,八,高鐵西九龍,出境,0,0,0,0
17/8/2020,八,紅磡,入境,0,0,0,0
17/8/2020,八,紅磡,出境,0,0,0,0
17/8/2020,八,羅湖,入境,0,0,0,0
17/8/2020,八,羅湖,出境,0,0,0,0
17/8/2020,八,落馬洲支線,入境,0,0,0,0
17/8/2020,八,落馬洲支線,出境,0,0,0,0
17/8/2020,八,港珠澳大橋,入境,48,0,7,55
17/8/2020,八,港珠澳大橋,出境,96,5,3,104
17/8/2020,八,落馬洲,入境,0,0,0,0
17/8/2020,八,落馬洲,出境,0,0,0,0
17/8/2020,八,文錦渡,入境,0,0,0,0
17/8/2020,八,文錦渡,出境,0,0,0,0
17/8/2020,八,沙頭角,入境,0,0,0,0
17/8/2020,八,沙頭角,出境,0,0,0,0
17/8/2020,八,深圳灣,入境,710,71,1,782
17/8/2020,八,深圳灣,出境,443,46,1,490
17/8/2020,八,中國客運碼頭,入境,0,0,0,0
17/8/2020,八,中國客運碼頭,出境,0,0,0,0
17/8/2020,八,港口管制,入境,0,0,0,0
17/8/2020,八,港口管制,出境,0,0,0,0
17/8/2020,八,啟德郵輪碼頭,入境,0,0,0,0
17/8/2020,八,啟德郵輪碼頭,出境,0,0,0,0
17/8/2020,八,港澳客輪碼頭,入境,0,0,0,0
17/8/2020,八,港澳客輪碼頭,出境,0,0,0,0
17/8/2020,八,屯門客運碼頭,入境,0,0,0,0
17/8/2020,八,屯門客運碼頭,出境,0,0,0,0
18/8/2020,八,機場,入境,435,0,14,449
18/8/2020,八,機場,出境,1253,19,48,1320
18/8/2020,八,高鐵西九龍,入境,0,0,0,0
18/8/2020,八,高鐵西九龍,出境,0,0,0,0
18/8/2020,八,紅磡,入境,0,0,0,0
18/8/2020,八,紅磡,出境,0,0,0,0
18/8/2020,八,羅湖,入境,0,0,0,0
18/8/2020,八,羅湖,出境,0,0,0,0
18/8/2020,八,落馬洲支線,入境,0,0,0,0
18/8/2020,八,落馬洲支線,出境,0,0,0,0
18/8/2020,八,港珠澳大橋,入境,57,1,7,65
18/8/2020,八,港珠澳大橋,出境,150,10,8,168
18/8/2020,八,落馬洲,入境,0,0,0,0
18/8/2020,八,落馬洲,出境,0,0,0,0
18/8/2020,八,文錦渡,入境,0,0,0,0
18/8/2020,八,文錦渡,出境,0,0,0,0
18/8/2020,八,沙頭角,入境,0,0,0,0
18/8/2020,八,沙頭角,出境,0,0,0,0
18/8/2020,八,深圳灣,入境,673,49,2,724
18/8/2020,八,深圳灣,出境,782,78,3,863
18/8/2020,八,中國客運碼頭,入境,0,0,0,0
18/8/2020,八,中國客運碼頭,出境,0,0,0,0
18/8/2020,八,港口管制,入境,0,0,0,0
18/8/2020,八,港口管制,出境,0,0,0,0
18/8/2020,八,啟德郵輪碼頭,入境,0,0,0,0
18/8/2020,八,啟德郵輪碼頭,出境,0,0,0,0
18/8/2020,八,港澳客輪碼頭,入境,0,0,0,0
18/8/2020,八,港澳客輪碼頭,出境,0,0,0,0
18/8/2020,八,屯門客運碼頭,入境,0,0,0,0
18/8/2020,八,屯門客運碼頭,出境,0,0,0,0
19/8/2020,八,機場,入境,501,1,21,523
19/8/2020,八,機場,出境,870,10,33,913
19/8/2020,八,高鐵西九龍,入境,0,0,0,0
19/8/2020,八,高鐵西九龍,出境,0,0,0,0
19/8/2020,八,紅磡,入境,0,0,0,0
19/8/2020,八,紅磡,出境,0,0,0,0
19/8/2020,八,羅湖,入境,0,0,0,0
19/8/2020,八,羅湖,出境,0,0,0,0
19/8/2020,八,落馬洲支線,入境,0,0,0,0
19/8/2020,八,落馬洲支線,出境,0,0,0,0
19/8/2020,八,港珠澳大橋,入境,17,0,2,19
19/8/2020,八,港珠澳大橋,出境,79,3,1,83
19/8/2020,八,落馬洲,入境,0,0,0,0
19/8/2020,八,落馬洲,出境,0,0,0,0
19/8/2020,八,文錦渡,入境,0,0,0,0
19/8/2020,八,文錦渡,出境,0,0,0,0
19/8/2020,八,沙頭角,入境,0,0,0,0
19/8/2020,八,沙頭角,出境,0,0,0,0
19/8/2020,八,深圳灣,入境,359,27,5,391
19/8/2020,八,深圳灣,出境,806,111,1,918
19/8/2020,八,中國客運碼頭,入境,0,0,0,0
19/8/2020,八,中國客運碼頭,出境,0,0,0,0
19/8/2020,八,港口管制,入境,0,0,0,0
19/8/2020,八,港口管制,出境,0,0,0,0
19/8/2020,八,啟德郵輪碼頭,入境,0,0,0,0
19/8/2020,八,啟德郵輪碼頭,出境,0,0,0,0
19/8/2020,八,港澳客輪碼頭,入境,0,0,0,0
19/8/2020,八,港澳客輪碼頭,出境,0,0,0,0
19/8/2020,八,屯門客運碼頭,入境,0,0,0,0
19/8/2020,八,屯門客運碼頭,出境,0,0,0,0
20/8/2020,八,機場,入境,712,1,29,742
20/8/2020,八,機場,出境,1260,6,54,1320
20/8/2020,八,高鐵西九龍,入境,0,0,0,0
20/8/2020,八,高鐵西九龍,出境,0,0,0,0
20/8/2020,八,紅磡,入境,0,0,0,0
20/8/2020,八,紅磡,出境,0,0,0,0
20/8/2020,八,羅湖,入境,0,0,0,0
20/8/2020,八,羅湖,出境,0,0,0,0
20/8/2020,八,落馬洲支線,入境,0,0,0,0
20/8/2020,八,落馬洲支線,出境,0,0,0,0
20/8/2020,八,港珠澳大橋,入境,43,2,12,57
20/8/2020,八,港珠澳大橋,出境,142,3,6,151
20/8/2020,八,落馬洲,入境,0,0,0,0
20/8/2020,八,落馬洲,出境,0,0,0,0
20/8/2020,八,文錦渡,入境,0,0,0,0
20/8/2020,八,文錦渡,出境,0,0,0,0
20/8/2020,八,沙頭角,入境,0,0,0,0
20/8/2020,八,沙頭角,出境,0,0,0,0
20/8/2020,八,深圳灣,入境,605,84,2,691
20/8/2020,八,深圳灣,出境,741,98,5,844
20/8/2020,八,中國客運碼頭,入境,0,0,0,0
20/8/2020,八,中國客運碼頭,出境,0,0,0,0
20/8/2020,八,港口管制,入境,0,0,0,0
20/8/2020,八,港口管制,出境,0,0,0,0
20/8/2020,八,啟德郵輪碼頭,入境,0,0,0,0
20/8/2020,八,啟德郵輪碼頭,出境,0,0,0,0
20/8/2020,八,港澳客輪碼頭,入境,0,0,0,0
20/8/2020,八,港澳客輪碼頭,出境,0,0,0,0
20/8/2020,八,屯門客運碼頭,入境,0,0,0,0
20/8/2020,八,屯門客運碼頭,出境,0,0,0,0
21/8/2020,八,機場,入境,722,10,25,757
21/8/2020,八,機場,出境,1681,27,184,1892
21/8/2020,八,高鐵西九龍,入境,0,0,0,0
21/8/2020,八,高鐵西九龍,出境,0,0,0,0
21/8/2020,八,紅磡,入境,0,0,0,0
21/8/2020,八,紅磡,出境,0,0,0,0
21/8/2020,八,羅湖,入境,0,0,0,0
21/8/2020,八,羅湖,出境,0,0,0,0
21/8/2020,八,落馬洲支線,入境,0,0,0,0
21/8/2020,八,落馬洲支線,出境,0,0,0,0
21/8/2020,八,港珠澳大橋,入境,54,3,89,146
21/8/2020,八,港珠澳大橋,出境,164,7,5,176
21/8/2020,八,落馬洲,入境,0,0,0,0
21/8/2020,八,落馬洲,出境,0,0,0,0
21/8/2020,八,文錦渡,入境,0,0,0,0
21/8/2020,八,文錦渡,出境,0,0,0,0
21/8/2020,八,沙頭角,入境,0,0,0,0
21/8/2020,八,沙頭角,出境,0,0,0,0
21/8/2020,八,深圳灣,入境,612,56,3,671
21/8/2020,八,深圳灣,出境,715,75,3,793
21/8/2020,八,中國客運碼頭,入境,0,0,0,0
21/8/2020,八,中國客運碼頭,出境,0,0,0,0
21/8/2020,八,港口管制,入境,0,0,0,0
21/8/2020,八,港口管制,出境,0,0,0,0
21/8/2020,八,啟德郵輪碼頭,入境,0,0,0,0
21/8/2020,八,啟德郵輪碼頭,出境,0,0,0,0
21/8/2020,八,港澳客輪碼頭,入境,0,0,0,0
21/8/2020,八,港澳客輪碼頭,出境,0,0,0,0
21/8/2020,八,屯門客運碼頭,入境,0,0,0,0
21/8/2020,八,屯門客運碼頭,出境,0,0,0,0
22/8/2020,八,機場,入境,570,1,12,583
22/8/2020,八,機場,出境,1530,26,48,1604
22/8/2020,八,高鐵西九龍,入境,0,0,0,0
22/8/2020,八,高鐵西九龍,出境,0,0,0,0
22/8/2020,八,紅磡,入境,0,0,0,0
22/8/2020,八,紅磡,出境,0,0,0,0
22/8/2020,八,羅湖,入境,0,0,0,0
22/8/2020,八,羅湖,出境,0,0,0,0
22/8/2020,八,落馬洲支線,入境,0,0,0,0
22/8/2020,八,落馬洲支線,出境,0,0,0,0
22/8/2020,八,港珠澳大橋,入境,41,4,5,50
22/8/2020,八,港珠澳大橋,出境,182,5,9,196
22/8/2020,八,落馬洲,入境,0,0,0,0
22/8/2020,八,落馬洲,出境,0,0,0,0
22/8/2020,八,文錦渡,入境,0,0,0,0
22/8/2020,八,文錦渡,出境,0,0,0,0
22/8/2020,八,沙頭角,入境,0,0,0,0
22/8/2020,八,沙頭角,出境,0,0,0,0
22/8/2020,八,深圳灣,入境,502,78,3,583
22/8/2020,八,深圳灣,出境,801,108,1,910
22/8/2020,八,中國客運碼頭,入境,0,0,0,0
22/8/2020,八,中國客運碼頭,出境,0,0,0,0
22/8/2020,八,港口管制,入境,0,0,0,0
22/8/2020,八,港口管制,出境,0,0,0,0
22/8/2020,八,啟德郵輪碼頭,入境,0,0,0,0
22/8/2020,八,啟德郵輪碼頭,出境,0,0,0,0
22/8/2020,八,港澳客輪碼頭,入境,0,0,0,0
22/8/2020,八,港澳客輪碼頭,出境,0,0,0,0
22/8/2020,八,屯門客運碼頭,入境,0,0,0,0
22/8/2020,八,屯門客運碼頭,出境,0,0,0,0
23/8/2020,八,機場,入境,865,10,48,923
23/8/2020,八,機場,出境,1790,27,60,1877
23/8/2020,八,高鐵西九龍,入境,0,0,0,0
23/8/2020,八,高鐵西九龍,出境,0,0,0,0
23/8/2020,八,紅磡,入境,0,0,0,0
23/8/2020,八,紅磡,出境,0,0,0,0
23/8/2020,八,羅湖,入境,0,0,0,0
23/8/2020,八,羅湖,出境,0,0,0,0
23/8/2020,八,落馬洲支線,入境,0,0,0,0
23/8/2020,八,落馬洲支線,出境,0,0,0,0
23/8/2020,八,港珠澳大橋,入境,52,1,0,53
23/8/2020,八,港珠澳大橋,出境,117,8,1,126
23/8/2020,八,落馬洲,入境,0,0,0,0
23/8/2020,八,落馬洲,出境,0,0,0,0
23/8/2020,八,文錦渡,入境,0,0,0,0
23/8/2020,八,文錦渡,出境,0,0,0,0
23/8/2020,八,沙頭角,入境,0,0,0,0
23/8/2020,八,沙頭角,出境,0,0,0,0
23/8/2020,八,深圳灣,入境,634,68,8,710
23/8/2020,八,深圳灣,出境,458,58,3,519
23/8/2020,八,中國客運碼頭,入境,0,0,0,0
23/8/2020,八,中國客運碼頭,出境,0,0,0,0
23/8/2020,八,港口管制,入境,0,0,0,0
23/8/2020,八,港口管制,出境,0,0,0,0
23/8/2020,八,啟德郵輪碼頭,入境,0,0,0,0
23/8/2020,八,啟德郵輪碼頭,出境,0,0,0,0
23/8/2020,八,港澳客輪碼頭,入境,0,0,0,0
23/8/2020,八,港澳客輪碼頭,出境,0,0,0,0
23/8/2020,八,屯門客運碼頭,入境,0,0,0,0
23/8/2020,八,屯門客運碼頭,出境,0,0,0,0
24/8/2020,八,機場,入境,611,8,9,628
24/8/2020,八,機場,出境,1045,22,81,1148
24/8/2020,八,高鐵西九龍,入境,0,0,0,0
24/8/2020,八,高鐵西九龍,出境,0,0,0,0
24/8/2020,八,紅磡,入境,0,0,0,0
24/8/2020,八,紅磡,出境,0,0,0,0
24/8/2020,八,羅湖,入境,0,0,0,0
24/8/2020,八,羅湖,出境,0,0,0,0
24/8/2020,八,落馬洲支線,入境,0,0,0,0
24/8/2020,八,落馬洲支線,出境,0,0,0,0
24/8/2020,八,港珠澳大橋,入境,46,1,2,49
24/8/2020,八,港珠澳大橋,出境,84,6,8,98
24/8/2020,八,落馬洲,入境,0,0,0,0
24/8/2020,八,落馬洲,出境,0,0,0,0
24/8/2020,八,文錦渡,入境,0,0,0,0
24/8/2020,八,文錦渡,出境,0,0,0,0
24/8/2020,八,沙頭角,入境,0,0,0,0
24/8/2020,八,沙頭角,出境,0,0,0,0
24/8/2020,八,深圳灣,入境,614,47,5,666
24/8/2020,八,深圳灣,出境,395,48,3,446
24/8/2020,八,中國客運碼頭,入境,0,0,0,0
24/8/2020,八,中國客運碼頭,出境,0,0,0,0
24/8/2020,八,港口管制,入境,0,0,0,0
24/8/2020,八,港口管制,出境,0,0,0,0
24/8/2020,八,啟德郵輪碼頭,入境,0,0,0,0
24/8/2020,八,啟德郵輪碼頭,出境,0,0,0,0
24/8/2020,八,港澳客輪碼頭,入境,0,0,0,0
24/8/2020,八,港澳客輪碼頭,出境,0,0,0,0
24/8/2020,八,屯門客運碼頭,入境,0,0,0,0
24/8/2020,八,屯門客運碼頭,出境,0,0,0,0
25/8/2020,八,機場,入境,433,9,10,452
25/8/2020,八,機場,出境,1498,19,91,1608
25/8/2020,八,高鐵西九龍,入境,0,0,0,0
25/8/2020,八,高鐵西九龍,出境,0,0,0,0
25/8/2020,八,紅磡,入境,0,0,0,0
25/8/2020,八,紅磡,出境,0,0,0,0
25/8/2020,八,羅湖,入境,0,0,0,0
25/8/2020,八,羅湖,出境,0,0,0,0
25/8/2020,八,落馬洲支線,入境,0,0,0,0
25/8/2020,八,落馬洲支線,出境,0,0,0,0
25/8/2020,八,港珠澳大橋,入境,55,4,3,62
25/8/2020,八,港珠澳大橋,出境,131,7,6,144
25/8/2020,八,落馬洲,入境,0,0,0,0
25/8/2020,八,落馬洲,出境,0,0,0,0
25/8/2020,八,文錦渡,入境,0,0,0,0
25/8/2020,八,文錦渡,出境,0,0,0,0
25/8/2020,八,沙頭角,入境,0,0,0,0
25/8/2020,八,沙頭角,出境,0,0,0,0
25/8/2020,八,深圳灣,入境,588,61,4,653
25/8/2020,八,深圳灣,出境,610,59,6,675
25/8/2020,八,中國客運碼頭,入境,0,0,0,0
25/8/2020,八,中國客運碼頭,出境,0,0,0,0
25/8/2020,八,港口管制,入境,0,0,0,0
25/8/2020,八,港口管制,出境,0,0,0,0
25/8/2020,八,啟德郵輪碼頭,入境,0,0,0,0
25/8/2020,八,啟德郵輪碼頭,出境,0,0,0,0
25/8/2020,八,港澳客輪碼頭,入境,0,0,0,0
25/8/2020,八,港澳客輪碼頭,出境,0,0,0,0
25/8/2020,八,屯門客運碼頭,入境,0,0,0,0
25/8/2020,八,屯門客運碼頭,出境,0,0,0,0
26/8/2020,八,機場,入境,588,2,30,620
26/8/2020,八,機場,出境,1002,10,56,1068
26/8/2020,八,高鐵西九龍,入境,0,0,0,0
26/8/2020,八,高鐵西九龍,出境,0,0,0,0
26/8/2020,八,紅磡,入境,0,0,0,0
26/8/2020,八,紅磡,出境,0,0,0,0
26/8/2020,八,羅湖,入境,0,0,0,0
26/8/2020,八,羅湖,出境,0,0,0,0
26/8/2020,八,落馬洲支線,入境,0,0,0,0
26/8/2020,八,落馬洲支線,出境,0,0,0,0
26/8/2020,八,香園圍,入境,0,0,0,0
26/8/2020,八,香園圍,出境,0,0,0,0
26/8/2020,八,港珠澳大橋,入境,59,2,3,64
26/8/2020,八,港珠澳大橋,出境,162,10,2,174
26/8/2020,八,落馬洲,入境,0,0,0,0
26/8/2020,八,落馬洲,出境,0,0,0,0
26/8/2020,八,文錦渡,入境,0,0,0,0
26/8/2020,八,文錦渡,出境,0,0,0,0
26/8/2020,八,沙頭角,入境,0,0,0,0
26/8/2020,八,沙頭角,出境,0,0,0,0
26/8/2020,八,深圳灣,入境,658,61,2,721
26/8/2020,八,深圳灣,出境,771,84,4,859
26/8/2020,八,中國客運碼頭,入境,0,0,0,0
26/8/2020,八,中國客運碼頭,出境,0,0,0,0
26/8/2020,八,港口管制,入境,0,0,0,0
26/8/2020,八,港口管制,出境,0,0,0,0
26/8/2020,八,啟德郵輪碼頭,入境,0,0,0,0
26/8/2020,八,啟德郵輪碼頭,出境,0,0,0,0
26/8/2020,八,港澳客輪碼頭,入境,0,0,0,0
26/8/2020,八,港澳客輪碼頭,出境,0,0,0,0
26/8/2020,八,屯門客運碼頭,入境,0,0,0,0
26/8/2020,八,屯門客運碼頭,出境,0,0,0,0
27/8/2020,八,機場,入境,628,4,13,645
27/8/2020,八,機場,出境,1292,3,49,1344
27/8/2020,八,高鐵西九龍,入境,0,0,0,0
27/8/2020,八,高鐵西九龍,出境,0,0,0,0
27/8/2020,八,紅磡,入境,0,0,0,0
27/8/2020,八,紅磡,出境,0,0,0,0
27/8/2020,八,羅湖,入境,0,0,0,0
27/8/2020,八,羅湖,出境,0,0,0,0
27/8/2020,八,落馬洲支線,入境,0,0,0,0
27/8/2020,八,落馬洲支線,出境,0,0,0,0
27/8/2020,八,香園圍,入境,0,0,0,0
27/8/2020,八,香園圍,出境,0,0,0,0
27/8/2020,八,港珠澳大橋,入境,67,1,2,70
27/8/2020,八,港珠澳大橋,出境,125,12,6,143
27/8/2020,八,落馬洲,入境,0,0,0,0
27/8/2020,八,落馬洲,出境,0,0,0,0
27/8/2020,八,文錦渡,入境,0,0,0,0
27/8/2020,八,文錦渡,出境,0,0,0,0
27/8/2020,八,沙頭角,入境,0,0,0,0
27/8/2020,八,沙頭角,出境,0,0,0,0
27/8/2020,八,深圳灣,入境,587,70,4,661
27/8/2020,八,深圳灣,出境,716,67,3,786
27/8/2020,八,中國客運碼頭,入境,0,0,0,0
27/8/2020,八,中國客運碼頭,出境,0,0,0,0
27/8/2020,八,港口管制,入境,0,0,0,0
27/8/2020,八,港口管制,出境,0,0,0,0
27/8/2020,八,啟德郵輪碼頭,入境,0,0,0,0
27/8/2020,八,啟德郵輪碼頭,出境,0,0,0,0
27/8/2020,八,港澳客輪碼頭,入境,0,0,0,0
27/8/2020,八,港澳客輪碼頭,出境,0,0,0,0
27/8/2020,八,屯門客運碼頭,入境,0,0,0,0
27/8/2020,八,屯門客運碼頭,出境,0,0,0,0
28/8/2020,八,機場,入境,795,9,35,839
28/8/2020,八,機場,出境,1624,13,82,1719
28/8/2020,八,高鐵西九龍,入境,0,0,0,0
28/8/2020,八,高鐵西九龍,出境,0,0,0,0
28/8/2020,八,紅磡,入境,0,0,0,0
28/8/2020,八,紅磡,出境,0,0,0,0
28/8/2020,八,羅湖,入境,0,0,0,0
28/8/2020,八,羅湖,出境,0,0,0,0
28/8/2020,八,落馬洲支線,入境,0,0,0,0
28/8/2020,八,落馬洲支線,出境,0,0,0,0
28/8/2020,八,香園圍,入境,0,0,0,0
28/8/2020,八,香園圍,出境,0,0,0,0
28/8/2020,八,港珠澳大橋,入境,64,1,1,66
28/8/2020,八,港珠澳大橋,出境,118,4,11,133
28/8/2020,八,落馬洲,入境,0,0,0,0
28/8/2020,八,落馬洲,出境,0,0,0,0
28/8/2020,八,文錦渡,入境,0,0,0,0
28/8/2020,八,文錦渡,出境,0,0,0,0
28/8/2020,八,沙頭角,入境,0,0,0,0
28/8/2020,八,沙頭角,出境,0,0,0,0
28/8/2020,八,深圳灣,入境,867,88,8,963
28/8/2020,八,深圳灣,出境,562,75,4,641
28/8/2020,八,中國客運碼頭,入境,0,0,0,0
28/8/2020,八,中國客運碼頭,出境,0,0,0,0
28/8/2020,八,港口管制,入境,0,0,0,0
28/8/2020,八,港口管制,出境,0,0,0,0
28/8/2020,八,啟德郵輪碼頭,入境,0,0,0,0
28/8/2020,八,啟德郵輪碼頭,出境,0,0,0,0
28/8/2020,八,港澳客輪碼頭,入境,0,0,0,0
28/8/2020,八,港澳客輪碼頭,出境,0,0,0,0
28/8/2020,八,屯門客運碼頭,入境,0,0,0,0
28/8/2020,八,屯門客運碼頭,出境,0,0,0,0
29/8/2020,八,機場,入境,805,4,17,826
29/8/2020,八,機場,出境,1912,42,224,2178
29/8/2020,八,高鐵西九龍,入境,0,0,0,0
29/8/2020,八,高鐵西九龍,出境,0,0,0,0
29/8/2020,八,紅磡,入境,0,0,0,0
29/8/2020,八,紅磡,出境,0,0,0,0
29/8/2020,八,羅湖,入境,0,0,0,0
29/8/2020,八,羅湖,出境,0,0,0,0
29/8/2020,八,落馬洲支線,入境,0,0,0,0
29/8/2020,八,落馬洲支線,出境,0,0,0,0
29/8/2020,八,香園圍,入境,0,0,0,0
29/8/2020,八,香園圍,出境,0,0,0,0
29/8/2020,八,港珠澳大橋,入境,68,3,13,84
29/8/2020,八,港珠澳大橋,出境,132,11,9,152
29/8/2020,八,落馬洲,入境,0,0,0,0
29/8/2020,八,落馬洲,出境,0,0,0,0
29/8/2020,八,文錦渡,入境,0,0,0,0
29/8/2020,八,文錦渡,出境,0,0,0,0
29/8/2020,八,沙頭角,入境,0,0,0,0
29/8/2020,八,沙頭角,出境,0,0,0,0
29/8/2020,八,深圳灣,入境,755,95,2,852
29/8/2020,八,深圳灣,出境,452,53,2,507
29/8/2020,八,中國客運碼頭,入境,0,0,0,0
29/8/2020,八,中國客運碼頭,出境,0,0,0,0
29/8/2020,八,港口管制,入境,0,0,0,0
29/8/2020,八,港口管制,出境,0,0,0,0
29/8/2020,八,啟德郵輪碼頭,入境,0,0,0,0
29/8/2020,八,啟德郵輪碼頭,出境,0,0,0,0
29/8/2020,八,港澳客輪碼頭,入境,0,0,0,0
29/8/2020,八,港澳客輪碼頭,出境,0,0,0,0
29/8/2020,八,屯門客運碼頭,入境,0,0,0,0
29/8/2020,八,屯門客運碼頭,出境,0,0,0,0
30/8/2020,八,機場,入境,1031,9,32,1072
30/8/2020,八,機場,出境,1645,10,57,1712
30/8/2020,八,高鐵西九龍,入境,0,0,0,0
30/8/2020,八,高鐵西九龍,出境,0,0,0,0
30/8/2020,八,紅磡,入境,0,0,0,0
30/8/2020,八,紅磡,出境,0,0,0,0
30/8/2020,八,羅湖,入境,0,0,0,0
30/8/2020,八,羅湖,出境,0,0,0,0
30/8/2020,八,落馬洲支線,入境,0,0,0,0
30/8/2020,八,落馬洲支線,出境,0,0,0,0
30/8/2020,八,香園圍,入境,0,0,0,0
30/8/2020,八,香園圍,出境,0,0,0,0
30/8/2020,八,港珠澳大橋,入境,87,6,4,97
30/8/2020,八,港珠澳大橋,出境,78,4,5,87
30/8/2020,八,落馬洲,入境,0,0,0,0
30/8/2020,八,落馬洲,出境,0,0,0,0
30/8/2020,八,文錦渡,入境,0,0,0,0
30/8/2020,八,文錦渡,出境,0,0,0,0
30/8/2020,八,沙頭角,入境,0,0,0,0
30/8/2020,八,沙頭角,出境,0,0,0,0
30/8/2020,八,深圳灣,入境,1160,113,1,1274
30/8/2020,八,深圳灣,出境,377,39,1,417
30/8/2020,八,中國客運碼頭,入境,0,0,0,0
30/8/2020,八,中國客運碼頭,出境,0,0,0,0
30/8/2020,八,港口管制,入境,0,0,0,0
30/8/2020,八,港口管制,出境,0,0,0,0
30/8/2020,八,啟德郵輪碼頭,入境,0,0,0,0
30/8/2020,八,啟德郵輪碼頭,出境,0,0,0,0
30/8/2020,八,港澳客輪碼頭,入境,0,0,0,0
30/8/2020,八,港澳客輪碼頭,出境,0,0,0,0
30/8/2020,八,屯門客運碼頭,入境,0,0,0,0
30/8/2020,八,屯門客運碼頭,出境,0,0,0,0
31/8/2020,八,機場,入境,616,2,14,632
31/8/2020,八,機場,出境,1921,6,40,1967
31/8/2020,八,高鐵西九龍,入境,0,0,0,0
31/8/2020,八,高鐵西九龍,出境,0,0,0,0
31/8/2020,八,紅磡,入境,0,0,0,0
31/8/2020,八,紅磡,出境,0,0,0,0
31/8/2020,八,羅湖,入境,0,0,0,0
31/8/2020,八,羅湖,出境,0,0,0,0
31/8/2020,八,落馬洲支線,入境,0,0,0,0
31/8/2020,八,落馬洲支線,出境,0,0,0,0
31/8/2020,八,香園圍,入境,0,0,0,0
31/8/2020,八,香園圍,出境,0,0,0,0
31/8/2020,八,港珠澳大橋,入境,97,5,4,106
31/8/2020,八,港珠澳大橋,出境,84,5,2,91
31/8/2020,八,落馬洲,入境,0,0,0,0
31/8/2020,八,落馬洲,出境,0,0,0,0
31/8/2020,八,文錦渡,入境,0,0,0,0
31/8/2020,八,文錦渡,出境,0,0,0,0
31/8/2020,八,沙頭角,入境,0,0,0,0
31/8/2020,八,沙頭角,出境,0,0,0,0
31/8/2020,八,深圳灣,入境,1276,96,2,1374
31/8/2020,八,深圳灣,出境,417,43,4,464
31/8/2020,八,中國客運碼頭,入境,0,0,0,0
31/8/2020,八,中國客運碼頭,出境,0,0,0,0
31/8/2020,八,港口管制,入境,0,0,0,0
31/8/2020,八,港口管制,出境,0,0,0,0
31/8/2020,八,啟德郵輪碼頭,入境,0,0,0,0
31/8/2020,八,啟德郵輪碼頭,出境,0,0,0,0
31/8/2020,八,港澳客輪碼頭,入境,0,0,0,0
31/8/2020,八,港澳客輪碼頭,出境,0,0,0,0
31/8/2020,八,屯門客運碼頭,入境,0,0,0,0
31/8/2020,八,屯門客運碼頭,出境,0,0,0,0
1/9/2020,八,機場,入境,545,4,22,571
1/9/2020,八,機場,出境,1956,18,57,2031
1/9/2020,八,高鐵西九龍,入境,0,0,0,0
1/9/2020,八,高鐵西九龍,出境,0,0,0,0
1/9/2020,八,紅磡,入境,0,0,0,0
1/9/2020,八,紅磡,出境,0,0,0,0
1/9/2020,八,羅湖,入境,0,0,0,0
1/9/2020,八,羅湖,出境,0,0,0,0
1/9/2020,八,落馬洲支線,入境,0,0,0,0
1/9/2020,八,落馬洲支線,出境,0,0,0,0
1/9/2020,八,香園圍,入境,0,0,0,0
1/9/2020,八,香園圍,出境,0,0,0,0
1/9/2020,八,港珠澳大橋,入境,65,1,1,67
1/9/2020,八,港珠澳大橋,出境,138,4,7,149
1/9/2020,八,落馬洲,入境,0,0,0,0
1/9/2020,八,落馬洲,出境,0,0,0,0
1/9/2020,八,文錦渡,入境,0,0,0,0
1/9/2020,八,文錦渡,出境,0,0,0,0
1/9/2020,八,沙頭角,入境,0,0,0,0
1/9/2020,八,沙頭角,出境,0,0,0,0
1/9/2020,八,深圳灣,入境,816,72,2,890
1/9/2020,八,深圳灣,出境,643,73,7,723
1/9/2020,八,中國客運碼頭,入境,0,0,0,0
1/9/2020,八,中國客運碼頭,出境,0,0,0,0
1/9/2020,八,港口管制,入境,0,0,0,0
1/9/2020,八,港口管制,出境,0,0,0,0
1/9/2020,八,啟德郵輪碼頭,入境,0,0,0,0
1/9/2020,八,啟德郵輪碼頭,出境,0,0,0,0
1/9/2020,八,港澳客輪碼頭,入境,0,0,0,0
1/9/2020,八,港澳客輪碼頭,出境,0,0,0,0
1/9/2020,八,屯門客運碼頭,入境,0,0,0,0
1/9/2020,八,屯門客運碼頭,出境,0,0,0,0
2/9/2020,八,機場,入境,735,6,37,778
2/9/2020,八,機場,出境,1647,26,40,1713
2/9/2020,八,高鐵西九龍,入境,0,0,0,0
2/9/2020,八,高鐵西九龍,出境,0,0,0,0
2/9/2020,八,紅磡,入境,0,0,0,0
2/9/2020,八,紅磡,出境,0,0,0,0
2/9/2020,八,羅湖,入境,0,0,0,0
2/9/2020,八,羅湖,出境,0,0,0,0
2/9/2020,八,落馬洲支線,入境,0,0,0,0
2/9/2020,八,落馬洲支線,出境,0,0,0,0
2/9/2020,八,香園圍,入境,0,0,0,0
2/9/2020,八,香園圍,出境,0,0,0,0
2/9/2020,八,港珠澳大橋,入境,57,5,1,63
2/9/2020,八,港珠澳大橋,出境,140,10,1,151
2/9/2020,八,落馬洲,入境,0,0,0,0
2/9/2020,八,落馬洲,出境,0,0,0,0
2/9/2020,八,文錦渡,入境,0,0,0,0
2/9/2020,八,文錦渡,出境,0,0,0,0
2/9/2020,八,沙頭角,入境,0,0,0,0
2/9/2020,八,沙頭角,出境,0,0,0,0
2/9/2020,八,深圳灣,入境,1012,89,2,1103
2/9/2020,八,深圳灣,出境,710,82,2,794
2/9/2020,八,中國客運碼頭,入境,0,0,0,0
2/9/2020,八,中國客運碼頭,出境,0,0,0,0
2/9/2020,八,港口管制,入境,0,0,0,0
2/9/2020,八,港口管制,出境,0,0,0,0
2/9/2020,八,啟德郵輪碼頭,入境,0,0,0,0
2/9/2020,八,啟德郵輪碼頭,出境,0,0,0,0
2/9/2020,八,港澳客輪碼頭,入境,0,0,0,0
2/9/2020,八,港澳客輪碼頭,出境,0,0,0,0
2/9/2020,八,屯門客運碼頭,入境,0,0,0,0
2/9/2020,八,屯門客運碼頭,出境,0,0,0,0
3/9/2020,八,機場,入境,622,4,15,641
3/9/2020,八,機場,出境,1466,12,28,1506
3/9/2020,八,高鐵西九龍,入境,0,0,0,0
3/9/2020,八,高鐵西九龍,出境,0,0,0,0
3/9/2020,八,紅磡,入境,0,0,0,0
3/9/2020,八,紅磡,出境,0,0,0,0
3/9/2020,八,羅湖,入境,0,0,0,0
3/9/2020,八,羅湖,出境,0,0,0,0
3/9/2020,八,落馬洲支線,入境,0,0,0,0
3/9/2020,八,落馬洲支線,出境,0,0,0,0
3/9/2020,八,香園圍,入境,0,0,0,0
3/9/2020,八,香園圍,出境,0,0,0,0
3/9/2020,八,港珠澳大橋,入境,84,4,4,92
3/9/2020,八,港珠澳大橋,出境,141,7,2,150
3/9/2020,八,落馬洲,入境,0,0,0,0
3/9/2020,八,落馬洲,出境,0,0,0,0
3/9/2020,八,文錦渡,入境,0,0,0,0
3/9/2020,八,文錦渡,出境,0,0,0,0
3/9/2020,八,沙頭角,入境,0,0,0,0
3/9/2020,八,沙頭角,出境,0,0,0,0
3/9/2020,八,深圳灣,入境,1032,79,4,1115
3/9/2020,八,深圳灣,出境,756,86,7,849
3/9/2020,八,中國客運碼頭,入境,0,0,0,0
3/9/2020,八,中國客運碼頭,出境,0,0,0,0
3/9/2020,八,港口管制,入境,0,0,0,0
3/9/2020,八,港口管制,出境,0,0,0,0
3/9/2020,八,啟德郵輪碼頭,入境,0,0,0,0
3/9/2020,八,啟德郵輪碼頭,出境,0,0,0,0
3/9/2020,八,港澳客輪碼頭,入境,0,0,0,0
3/9/2020,八,港澳客輪碼頭,出境,0,0,0,0
3/9/2020,八,屯門客運碼頭,入境,0,0,0,0
3/9/2020,八,屯門客運碼頭,出境,0,0,0,0
4/9/2020,八,機場,入境,1231,5,32,1268
4/9/2020,八,機場,出境,1377,16,41,1434
4/9/2020,八,高鐵西九龍,入境,0,0,0,0
4/9/2020,八,高鐵西九龍,出境,0,0,0,0
4/9/2020,八,紅磡,入境,0,0,0,0
4/9/2020,八,紅磡,出境,0,0,0,0
4/9/2020,八,羅湖,入境,0,0,0,0
4/9/2020,八,羅湖,出境,0,0,0,0
4/9/2020,八,落馬洲支線,入境,0,0,0,0
4/9/2020,八,落馬洲支線,出境,0,0,0,0
4/9/2020,八,香園圍,入境,0,0,0,0
4/9/2020,八,香園圍,出境,0,0,0,0
4/9/2020,八,港珠澳大橋,入境,72,2,6,80
4/9/2020,八,港珠澳大橋,出境,175,6,9,190
4/9/2020,八,落馬洲,入境,0,0,0,0
4/9/2020,八,落馬洲,出境,0,0,0,0
4/9/2020,八,文錦渡,入境,0,0,0,0
4/9/2020,八,文錦渡,出境,0,0,0,0
4/9/2020,八,沙頭角,入境,0,0,0,0
4/9/2020,八,沙頭角,出境,0,0,0,0
4/9/2020,八,深圳灣,入境,845,114,4,963
4/9/2020,八,深圳灣,出境,695,80,2,777
4/9/2020,八,中國客運碼頭,入境,0,0,0,0
4/9/2020,八,中國客運碼頭,出境,0,0,0,0
4/9/2020,八,港口管制,入境,0,0,0,0
4/9/2020,八,港口管制,出境,0,0,0,0
4/9/2020,八,啟德郵輪碼頭,入境,0,0,0,0
4/9/2020,八,啟德郵輪碼頭,出境,0,0,0,0
4/9/2020,八,港澳客輪碼頭,入境,0,0,0,0
4/9/2020,八,港澳客輪碼頭,出境,0,0,0,0
4/9/2020,八,屯門客運碼頭,入境,0,0,0,0
4/9/2020,八,屯門客運碼頭,出境,0,0,0,0
5/9/2020,八,機場,入境,1046,11,28,1085
5/9/2020,八,機場,出境,1900,40,70,2010
5/9/2020,八,高鐵西九龍,入境,0,0,0,0
5/9/2020,八,高鐵西九龍,出境,0,0,0,0
5/9/2020,八,紅磡,入境,0,0,0,0
5/9/2020,八,紅磡,出境,0,0,0,0
5/9/2020,八,羅湖,入境,0,0,0,0
5/9/2020,八,羅湖,出境,0,0,0,0
5/9/2020,八,落馬洲支線,入境,0,0,0,0
5/9/2020,八,落馬洲支線,出境,0,0,0,0
5/9/2020,八,香園圍,入境,0,0,0,0
5/9/2020,八,香園圍,出境,0,0,0,0
5/9/2020,八,港珠澳大橋,入境,71,4,6,81
5/9/2020,八,港珠澳大橋,出境,100,6,6,112
5/9/2020,八,落馬洲,入境,0,0,0,0
5/9/2020,八,落馬洲,出境,0,0,0,0
5/9/2020,八,文錦渡,入境,0,0,0,0
5/9/2020,八,文錦渡,出境,0,0,0,0
5/9/2020,八,沙頭角,入境,0,0,0,0
5/9/2020,八,沙頭角,出境,0,0,0,0
5/9/2020,八,深圳灣,入境,1401,154,5,1560
5/9/2020,八,深圳灣,出境,550,82,3,635
5/9/2020,八,中國客運碼頭,入境,0,0,0,0
5/9/2020,八,中國客運碼頭,出境,0,0,0,0
5/9/2020,八,港口管制,入境,0,0,0,0
5/9/2020,八,港口管制,出境,0,0,0,0
5/9/2020,八,啟德郵輪碼頭,入境,0,0,0,0
5/9/2020,八,啟德郵輪碼頭,出境,0,0,0,0
5/9/2020,八,港澳客輪碼頭,入境,0,0,0,0
5/9/2020,八,港澳客輪碼頭,出境,0,0,0,0
5/9/2020,八,屯門客運碼頭,入境,0,0,0,0
5/9/2020,八,屯門客運碼頭,出境,0,0,0,0
6/9/2020,八,機場,入境,1093,5,51,1149
6/9/2020,八,機場,出境,1633,31,69,1733
6/9/2020,八,高鐵西九龍,入境,0,0,0,0
6/9/2020,八,高鐵西九龍,出境,0,0,0,0
6/9/2020,八,紅磡,入境,0,0,0,0
6/9/2020,八,紅磡,出境,0,0,0,0
6/9/2020,八,羅湖,入境,0,0,0,0
6/9/2020,八,羅湖,出境,0,0,0,0
6/9/2020,八,落馬洲支線,入境,0,0,0,0
6/9/2020,八,落馬洲支線,出境,0,0,0,0
6/9/2020,八,香園圍,入境,0,0,0,0
6/9/2020,八,香園圍,出境,0,0,0,0
6/9/2020,八,港珠澳大橋,入境,199,10,6,215
6/9/2020,八,港珠澳大橋,出境,39,3,0,42
6/9/2020,八,落馬洲,入境,0,0,0,0
6/9/2020,八,落馬洲,出境,0,0,0,0
6/9/2020,八,文錦渡,入境,0,0,0,0
6/9/2020,八,文錦渡,出境,0,0,0,0
6/9/2020,八,沙頭角,入境,0,0,0,0
6/9/2020,八,沙頭角,出境,0,0,0,0
6/9/2020,八,深圳灣,入境,2543,257,12,2812
6/9/2020,八,深圳灣,出境,337,44,2,383
6/9/2020,八,中國客運碼頭,入境,0,0,0,0
6/9/2020,八,中國客運碼頭,出境,0,0,0,0
6/9/2020,八,港口管制,入境,0,0,0,0
6/9/2020,八,港口管制,出境,0,0,0,0
6/9/2020,八,啟德郵輪碼頭,入境,0,0,0,0
6/9/2020,八,啟德郵輪碼頭,出境,0,0,0,0
6/9/2020,八,港澳客輪碼頭,入境,0,0,0,0
6/9/2020,八,港澳客輪碼頭,出境,0,0,0,0
6/9/2020,八,屯門客運碼頭,入境,0,0,0,0
6/9/2020,八,屯門客運碼頭,出境,0,0,0,0
7/9/2020,八,機場,入境,614,5,19,638
7/9/2020,八,機場,出境,1242,5,39,1286
7/9/2020,八,高鐵西九龍,入境,0,0,0,0
7/9/2020,八,高鐵西九龍,出境,0,0,0,0
7/9/2020,八,紅磡,入境,0,0,0,0
7/9/2020,八,紅磡,出境,0,0,0,0
7/9/2020,八,羅湖,入境,0,0,0,0
7/9/2020,八,羅湖,出境,0,0,0,0
7/9/2020,八,落馬洲支線,入境,0,0,0,0
7/9/2020,八,落馬洲支線,出境,0,0,0,0
7/9/2020,八,香園圍,入境,0,0,0,0
7/9/2020,八,香園圍,出境,0,0,0,0
7/9/2020,八,港珠澳大橋,入境,125,8,4,137
7/9/2020,八,港珠澳大橋,出境,71,3,1,75
7/9/2020,八,落馬洲,入境,0,0,0,0
7/9/2020,八,落馬洲,出境,0,0,0,0
7/9/2020,八,文錦渡,入境,0,0,0,0
7/9/2020,八,文錦渡,出境,0,0,0,0
7/9/2020,八,沙頭角,入境,0,0,0,0
7/9/2020,八,沙頭角,出境,0,0,0,0
7/9/2020,八,深圳灣,入境,1680,170,6,1856
7/9/2020,八,深圳灣,出境,360,43,2,405
7/9/2020,八,中國客運碼頭,入境,0,0,0,0
7/9/2020,八,中國客運碼頭,出境,0,0,0,0
7/9/2020,八,港口管制,入境,0,0,0,0
7/9/2020,八,港口管制,出境,0,0,0,0
7/9/2020,八,啟德郵輪碼頭,入境,0,0,0,0
7/9/2020,八,啟德郵輪碼頭,出境,0,0,0,0
7/9/2020,八,港澳客輪碼頭,入境,0,0,0,0
7/9/2020,八,港澳客輪碼頭,出境,0,0,0,0
7/9/2020,八,屯門客運碼頭,入境,0,0,0,0
7/9/2020,八,屯門客運碼頭,出境,0,0,0,0
8/9/2020,八,機場,入境,1030,9,45,1084
8/9/2020,八,機場,出境,1378,27,46,1451
8/9/2020,八,高鐵西九龍,入境,0,0,0,0
8/9/2020,八,高鐵西九龍,出境,0,0,0,0
8/9/2020,八,紅磡,入境,0,0,0,0
8/9/2020,八,紅磡,出境,0,0,0,0
8/9/2020,八,羅湖,入境,0,0,0,0
8/9/2020,八,羅湖,出境,0,0,0,0
8/9/2020,八,落馬洲支線,入境,0,0,0,0
8/9/2020,八,落馬洲支線,出境,0,0,0,0
8/9/2020,八,香園圍,入境,0,0,0,0
8/9/2020,八,香園圍,出境,0,0,0,0
8/9/2020,八,港珠澳大橋,入境,167,10,5,182
8/9/2020,八,港珠澳大橋,出境,114,12,3,129
8/9/2020,八,落馬洲,入境,0,0,0,0
8/9/2020,八,落馬洲,出境,0,0,0,0
8/9/2020,八,文錦渡,入境,0,0,0,0
8/9/2020,八,文錦渡,出境,0,0,0,0
8/9/2020,八,沙頭角,入境,0,0,0,0
8/9/2020,八,沙頭角,出境,0,0,0,0
8/9/2020,八,深圳灣,入境,2340,290,7,2637
8/9/2020,八,深圳灣,出境,735,64,7,806
8/9/2020,八,中國客運碼頭,入境,0,0,0,0
8/9/2020,八,中國客運碼頭,出境,0,0,0,0
8/9/2020,八,港口管制,入境,0,0,0,0
8/9/2020,八,港口管制,出境,0,0,0,0
8/9/2020,八,啟德郵輪碼頭,入境,0,0,0,0
8/9/2020,八,啟德郵輪碼頭,出境,0,0,0,0
8/9/2020,八,港澳客輪碼頭,入境,0,0,0,0
8/9/2020,八,港澳客輪碼頭,出境,0,0,0,0
8/9/2020,八,屯門客運碼頭,入境,0,0,0,0
8/9/2020,八,屯門客運碼頭,出境,0,0,0,0
9/9/2020,八,機場,入境,916,9,24,949
9/9/2020,八,機場,出境,1181,18,115,1314
9/9/2020,八,高鐵西九龍,入境,0,0,0,0
9/9/2020,八,高鐵西九龍,出境,0,0,0,0
9/9/2020,八,紅磡,入境,0,0,0,0
9/9/2020,八,紅磡,出境,0,0,0,0
9/9/2020,八,羅湖,入境,0,0,0,0
9/9/2020,八,羅湖,出境,0,0,0,0
9/9/2020,八,落馬洲支線,入境,0,0,0,0
9/9/2020,八,落馬洲支線,出境,0,0,0,0
9/9/2020,八,香園圍,入境,0,0,0,0
9/9/2020,八,香園圍,出境,0,0,0,0
9/9/2020,八,港珠澳大橋,入境,137,7,50,194
9/9/2020,八,港珠澳大橋,出境,113,9,3,125
9/9/2020,八,落馬洲,入境,0,0,0,0
9/9/2020,八,落馬洲,出境,0,0,0,0
9/9/2020,八,文錦渡,入境,0,0,0,0
9/9/2020,八,文錦渡,出境,0,0,0,0
9/9/2020,八,沙頭角,入境,0,0,0,0
9/9/2020,八,沙頭角,出境,0,0,0,0
9/9/2020,八,深圳灣,入境,2182,291,9,2482
9/9/2020,八,深圳灣,出境,636,96,4,736
9/9/2020,八,中國客運碼頭,入境,0,0,0,0
9/9/2020,八,中國客運碼頭,出境,0,0,0,0
9/9/2020,八,港口管制,入境,0,0,0,0
9/9/2020,八,港口管制,出境,0,0,0,0
9/9/2020,八,啟德郵輪碼頭,入境,0,0,0,0
9/9/2020,八,啟德郵輪碼頭,出境,0,0,0,0
9/9/2020,八,港澳客輪碼頭,入境,0,0,0,0
9/9/2020,八,港澳客輪碼頭,出境,0,0,0,0
9/9/2020,八,屯門客運碼頭,入境,0,0,0,0
9/9/2020,八,屯門客運碼頭,出境,0,0,0,0
10/9/2020,八,機場,入境,688,4,15,707
10/9/2020,八,機場,出境,1199,11,37,1247
10/9/2020,八,高鐵西九龍,入境,0,0,0,0
10/9/2020,八,高鐵西九龍,出境,0,0,0,0
10/9/2020,八,紅磡,入境,0,0,0,0
10/9/2020,八,紅磡,出境,0,0,0,0
10/9/2020,八,羅湖,入境,0,0,0,0
10/9/2020,八,羅湖,出境,0,0,0,0
10/9/2020,八,落馬洲支線,入境,0,0,0,0
10/9/2020,八,落馬洲支線,出境,0,0,0,0
10/9/2020,八,香園圍,入境,0,0,0,0
10/9/2020,八,香園圍,出境,0,0,0,0
10/9/2020,八,港珠澳大橋,入境,125,9,3,137
10/9/2020,八,港珠澳大橋,出境,136,7,7,150
10/9/2020,八,落馬洲,入境,0,0,0,0
10/9/2020,八,落馬洲,出境,0,0,0,0
10/9/2020,八,文錦渡,入境,0,0,0,0
10/9/2020,八,文錦渡,出境,0,0,0,0
10/9/2020,八,沙頭角,入境,0,0,0,0
10/9/2020,八,沙頭角,出境,0,0,0,0
10/9/2020,八,深圳灣,入境,1317,171,7,1495
10/9/2020,八,深圳灣,出境,612,84,6,702
10/9/2020,八,中國客運碼頭,入境,0,0,0,0
10/9/2020,八,中國客運碼頭,出境,0,0,0,0
10/9/2020,八,港口管制,入境,0,0,0,0
10/9/2020,八,港口管制,出境,0,0,0,0
10/9/2020,八,啟德郵輪碼頭,入境,0,0,0,0
10/9/2020,八,啟德郵輪碼頭,出境,0,0,0,0
10/9/2020,八,港澳客輪碼頭,入境,0,0,0,0
10/9/2020,八,港澳客輪碼頭,出境,0,0,0,0
10/9/2020,八,屯門客運碼頭,入境,0,0,0,0
10/9/2020,八,屯門客運碼頭,出境,0,0,0,0
11/9/2020,八,機場,入境,1166,7,44,1217
11/9/2020,八,機場,出境,1430,9,56,1495
11/9/2020,八,高鐵西九龍,入境,0,0,0,0
11/9/2020,八,高鐵西九龍,出境,0,0,0,0
11/9/2020,八,紅磡,入境,0,0,0,0
11/9/2020,八,紅磡,出境,0,0,0,0
11/9/2020,八,羅湖,入境,0,0,0,0
11/9/2020,八,羅湖,出境,0,0,0,0
11/9/2020,八,落馬洲支線,入境,0,0,0,0
11/9/2020,八,落馬洲支線,出境,0,0,0,0
11/9/2020,八,香園圍,入境,0,0,0,0
11/9/2020,八,香園圍,出境,0,0,0,0
11/9/2020,八,港珠澳大橋,入境,110,7,7,124
11/9/2020,八,港珠澳大橋,出境,133,8,2,143
11/9/2020,八,落馬洲,入境,0,0,0,0
11/9/2020,八,落馬洲,出境,0,0,0,0
11/9/2020,八,文錦渡,入境,0,0,0,0
11/9/2020,八,文錦渡,出境,0,0,0,0
11/9/2020,八,沙頭角,入境,0,0,0,0
11/9/2020,八,沙頭角,出境,0,0,0,0
11/9/2020,八,深圳灣,入境,1213,180,6,1399
11/9/2020,八,深圳灣,出境,537,89,5,631
11/9/2020,八,中國客運碼頭,入境,0,0,0,0
11/9/2020,八,中國客運碼頭,出境,0,0,0,0
11/9/2020,八,港口管制,入境,0,0,0,0
11/9/2020,八,港口管制,出境,0,0,0,0
11/9/2020,八,啟德郵輪碼頭,入境,0,0,0,0
11/9/2020,八,啟德郵輪碼頭,出境,0,0,0,0
11/9/2020,八,港澳客輪碼頭,入境,0,0,0,0
11/9/2020,八,港澳客輪碼頭,出境,0,0,0,0
11/9/2020,八,屯門客運碼頭,入境,0,0,0,0
11/9/2020,八,屯門客運碼頭,出境,0,0,0,0
12/9/2020,八,機場,入境,959,15,39,1013
12/9/2020,八,機場,出境,1457,40,46,1543
12/9/2020,八,高鐵西九龍,入境,0,0,0,0
12/9/2020,八,高鐵西九龍,出境,0,0,0,0
12/9/2020,八,紅磡,入境,0,0,0,0
12/9/2020,八,紅磡,出境,0,0,0,0
12/9/2020,八,羅湖,入境,0,0,0,0
12/9/2020,八,羅湖,出境,0,0,0,0
12/9/2020,八,落馬洲支線,入境,0,0,0,0
12/9/2020,八,落馬洲支線,出境,0,0,0,0
12/9/2020,八,香園圍,入境,0,0,0,0
12/9/2020,八,香園圍,出境,0,0,0,0
12/9/2020,八,港珠澳大橋,入境,109,13,5,127
12/9/2020,八,港珠澳大橋,出境,101,8,3,112
12/9/2020,八,落馬洲,入境,0,0,0,0
12/9/2020,八,落馬洲,出境,0,0,0,0
12/9/2020,八,文錦渡,入境,0,0,0,0
12/9/2020,八,文錦渡,出境,0,0,0,0
12/9/2020,八,沙頭角,入境,0,0,0,0
12/9/2020,八,沙頭角,出境,0,0,0,0
12/9/2020,八,深圳灣,入境,1576,251,4,1831
12/9/2020,八,深圳灣,出境,576,88,2,666
12/9/2020,八,中國客運碼頭,入境,0,0,0,0
12/9/2020,八,中國客運碼頭,出境,0,0,0,0
12/9/2020,八,港口管制,入境,0,0,0,0
12/9/2020,八,港口管制,出境,0,0,0,0
12/9/2020,八,啟德郵輪碼頭,入境,0,0,0,0
12/9/2020,八,啟德郵輪碼頭,出境,0,0,0,0
12/9/2020,八,港澳客輪碼頭,入境,0,0,0,0
12/9/2020,八,港澳客輪碼頭,出境,0,0,0,0
12/9/2020,八,屯門客運碼頭,入境,0,0,0,0
12/9/2020,八,屯門客運碼頭,出境,0,0,0,0
13/9/2020,八,機場,入境,1351,9,49,1409
13/9/2020,八,機場,出境,1426,29,60,1515
13/9/2020,八,高鐵西九龍,入境,0,0,0,0
13/9/2020,八,高鐵西九龍,出境,0,0,0,0
13/9/2020,八,紅磡,入境,0,0,0,0
13/9/2020,八,紅磡,出境,0,0,0,0
13/9/2020,八,羅湖,入境,0,0,0,0
13/9/2020,八,羅湖,出境,0,0,0,0
13/9/2020,八,落馬洲支線,入境,0,0,0,0
13/9/2020,八,落馬洲支線,出境,0,0,0,0
13/9/2020,八,香園圍,入境,0,0,0,0
13/9/2020,八,香園圍,出境,0,0,0,0
13/9/2020,八,港珠澳大橋,入境,229,20,7,256
13/9/2020,八,港珠澳大橋,出境,70,2,4,76
13/9/2020,八,落馬洲,入境,0,0,0,0
13/9/2020,八,落馬洲,出境,0,0,0,0
13/9/2020,八,文錦渡,入境,0,0,0,0
13/9/2020,八,文錦渡,出境,0,0,0,0
13/9/2020,八,沙頭角,入境,0,0,0,0
13/9/2020,八,沙頭角,出境,0,0,0,0
13/9/2020,八,深圳灣,入境,3251,443,9,3703
13/9/2020,八,深圳灣,出境,416,72,3,491
13/9/2020,八,中國客運碼頭,入境,0,0,0,0
13/9/2020,八,中國客運碼頭,出境,0,0,0,0
13/9/2020,八,港口管制,入境,0,0,0,0
13/9/2020,八,港口管制,出境,0,0,0,0
13/9/2020,八,啟德郵輪碼頭,入境,0,0,0,0
13/9/2020,八,啟德郵輪碼頭,出境,0,0,0,0
13/9/2020,八,港澳客輪碼頭,入境,0,0,0,0
13/9/2020,八,港澳客輪碼頭,出境,0,0,0,0
13/9/2020,八,屯門客運碼頭,入境,0,0,0,0
13/9/2020,八,屯門客運碼頭,出境,0,0,0,0
14/9/2020,八,機場,入境,656,4,26,686
14/9/2020,八,機場,出境,866,8,38,912
14/9/2020,八,高鐵西九龍,入境,0,0,0,0
14/9/2020,八,高鐵西九龍,出境,0,0,0,0
14/9/2020,八,紅磡,入境,0,0,0,0
14/9/2020,八,紅磡,出境,0,0,0,0
14/9/2020,八,羅湖,入境,0,0,0,0
14/9/2020,八,羅湖,出境,0,0,0,0
14/9/2020,八,落馬洲支線,入境,0,0,0,0
14/9/2020,八,落馬洲支線,出境,0,0,0,0
14/9/2020,八,香園圍,入境,0,0,0,0
14/9/2020,八,香園圍,出境,0,0,0,0
14/9/2020,八,港珠澳大橋,入境,160,9,3,172
14/9/2020,八,港珠澳大橋,出境,87,2,3,92
14/9/2020,八,落馬洲,入境,0,0,0,0
14/9/2020,八,落馬洲,出境,0,0,0,0
14/9/2020,八,文錦渡,入境,0,0,0,0
14/9/2020,八,文錦渡,出境,0,0,0,0
14/9/2020,八,沙頭角,入境,0,0,0,0
14/9/2020,八,沙頭角,出境,0,0,0,0
14/9/2020,八,深圳灣,入境,2277,302,7,2586
14/9/2020,八,深圳灣,出境,415,45,4,464
14/9/2020,八,中國客運碼頭,入境,0,0,0,0
14/9/2020,八,中國客運碼頭,出境,0,0,0,0
14/9/2020,八,港口管制,入境,0,0,0,0
14/9/2020,八,港口管制,出境,0,0,0,0
14/9/2020,八,啟德郵輪碼頭,入境,0,0,0,0
14/9/2020,八,啟德郵輪碼頭,出境,0,0,0,0
14/9/2020,八,港澳客輪碼頭,入境,0,0,0,0
14/9/2020,八,港澳客輪碼頭,出境,0,0,0,0
14/9/2020,八,屯門客運碼頭,入境,0,0,0,0
14/9/2020,八,屯門客運碼頭,出境,0,0,0,0
15/9/2020,八,機場,入境,754,7,40,801
15/9/2020,八,機場,出境,1340,18,64,1422
15/9/2020,八,高鐵西九龍,入境,0,0,0,0
15/9/2020,八,高鐵西九龍,出境,0,0,0,0
15/9/2020,八,紅磡,入境,0,0,0,0
15/9/2020,八,紅磡,出境,0,0,0,0
15/9/2020,八,羅湖,入境,0,0,0,0
15/9/2020,八,羅湖,出境,0,0,0,0
15/9/2020,八,落馬洲支線,入境,0,0,0,0
15/9/2020,八,落馬洲支線,出境,0,0,0,0
15/9/2020,八,香園圍,入境,0,0,0,0
15/9/2020,八,香園圍,出境,0,0,0,0
15/9/2020,八,港珠澳大橋,入境,125,6,5,136
15/9/2020,八,港珠澳大橋,出境,128,3,3,134
15/9/2020,八,落馬洲,入境,0,0,0,0
15/9/2020,八,落馬洲,出境,0,0,0,0
15/9/2020,八,文錦渡,入境,0,0,0,0
15/9/2020,八,文錦渡,出境,0,0,0,0
15/9/2020,八,沙頭角,入境,0,0,0,0
15/9/2020,八,沙頭角,出境,0,0,0,0
15/9/2020,八,深圳灣,入境,1764,263,9,2036
15/9/2020,八,深圳灣,出境,550,51,2,603
15/9/2020,八,中國客運碼頭,入境,0,0,0,0
15/9/2020,八,中國客運碼頭,出境,0,0,0,0
15/9/2020,八,港口管制,入境,0,0,0,0
15/9/2020,八,港口管制,出境,0,0,0,0
15/9/2020,八,啟德郵輪碼頭,入境,0,0,0,0
15/9/2020,八,啟德郵輪碼頭,出境,0,0,0,0
15/9/2020,八,港澳客輪碼頭,入境,0,0,0,0
15/9/2020,八,港澳客輪碼頭,出境,0,0,0,0
15/9/2020,八,屯門客運碼頭,入境,0,0,0,0
15/9/2020,八,屯門客運碼頭,出境,0,0,0,0
16/9/2020,八,機場,入境,799,10,30,839
16/9/2020,八,機場,出境,1065,17,47,1129
16/9/2020,八,高鐵西九龍,入境,0,0,0,0
16/9/2020,八,高鐵西九龍,出境,0,0,0,0
16/9/2020,八,紅磡,入境,0,0,0,0
16/9/2020,八,紅磡,出境,0,0,0,0
16/9/2020,八,羅湖,入境,0,0,0,0
16/9/2020,八,羅湖,出境,0,0,0,0
16/9/2020,八,落馬洲支線,入境,0,0,0,0
16/9/2020,八,落馬洲支線,出境,0,0,0,0
16/9/2020,八,香園圍,入境,0,0,0,0
16/9/2020,八,香園圍,出境,0,0,0,0
16/9/2020,八,港珠澳大橋,入境,73,3,2,78
16/9/2020,八,港珠澳大橋,出境,321,11,7,339
16/9/2020,八,落馬洲,入境,0,0,0,0
16/9/2020,八,落馬洲,出境,0,0,0,0
16/9/2020,八,文錦渡,入境,0,0,0,0
16/9/2020,八,文錦渡,出境,0,0,0,0
16/9/2020,八,沙頭角,入境,0,0,0,0
16/9/2020,八,沙頭角,出境,0,0,0,0
16/9/2020,八,深圳灣,入境,1091,183,5,1279
16/9/2020,八,深圳灣,出境,1189,85,5,1279
16/9/2020,八,中國客運碼頭,入境,0,0,0,0
16/9/2020,八,中國客運碼頭,出境,0,0,0,0
16/9/2020,八,港口管制,入境,0,0,0,0
16/9/2020,八,港口管制,出境,0,0,0,0
16/9/2020,八,啟德郵輪碼頭,入境,0,0,0,0
16/9/2020,八,啟德郵輪碼頭,出境,0,0,0,0
16/9/2020,八,港澳客輪碼頭,入境,0,0,0,0
16/9/2020,八,港澳客輪碼頭,出境,0,0,0,0
16/9/2020,八,屯門客運碼頭,入境,0,0,0,0
16/9/2020,八,屯門客運碼頭,出境,0,0,0,0
17/9/2020,八,機場,入境,650,5,21,676
17/9/2020,八,機場,出境,1276,6,42,1324
17/9/2020,八,高鐵西九龍,入境,0,0,0,0
17/9/2020,八,高鐵西九龍,出境,0,0,0,0
17/9/2020,八,紅磡,入境,0,0,0,0
17/9/2020,八,紅磡,出境,0,0,0,0
17/9/2020,八,羅湖,入境,0,0,0,0
17/9/2020,八,羅湖,出境,0,0,0,0
17/9/2020,八,落馬洲支線,入境,0,0,0,0
17/9/2020,八,落馬洲支線,出境,0,0,0,0
17/9/2020,八,香園圍,入境,0,0,0,0
17/9/2020,八,香園圍,出境,0,0,0,0
17/9/2020,八,港珠澳大橋,入境,72,4,1,77
17/9/2020,八,港珠澳大橋,出境,87,9,4,100
17/9/2020,八,落馬洲,入境,0,0,0,0
17/9/2020,八,落馬洲,出境,0,0,0,0
17/9/2020,八,文錦渡,入境,0,0,0,0
17/9/2020,八,文錦渡,出境,0,0,0,0
17/9/2020,八,沙頭角,入境,0,0,0,0
17/9/2020,八,沙頭角,出境,0,0,0,0
17/9/2020,八,深圳灣,入境,844,103,0,947
17/9/2020,八,深圳灣,出境,459,37,3,499
17/9/2020,八,中國客運碼頭,入境,0,0,0,0
17/9/2020,八,中國客運碼頭,出境,0,0,0,0
17/9/2020,八,港口管制,入境,0,0,0,0
17/9/2020,八,港口管制,出境,0,0,0,0
17/9/2020,八,啟德郵輪碼頭,入境,0,0,0,0
17/9/2020,八,啟德郵輪碼頭,出境,0,0,0,0
17/9/2020,八,港澳客輪碼頭,入境,0,0,0,0
17/9/2020,八,港澳客輪碼頭,出境,0,0,0,0
17/9/2020,八,屯門客運碼頭,入境,0,0,0,0
17/9/2020,八,屯門客運碼頭,出境,0,0,0,0
18/9/2020,八,機場,入境,822,4,41,867
18/9/2020,八,機場,出境,1336,5,41,1382
18/9/2020,八,高鐵西九龍,入境,0,0,0,0
18/9/2020,八,高鐵西九龍,出境,0,0,0,0
18/9/2020,八,紅磡,入境,0,0,0,0
18/9/2020,八,紅磡,出境,0,0,0,0
18/9/2020,八,羅湖,入境,0,0,0,0
18/9/2020,八,羅湖,出境,0,0,0,0
18/9/2020,八,落馬洲支線,入境,0,0,0,0
18/9/2020,八,落馬洲支線,出境,0,0,0,0
18/9/2020,八,香園圍,入境,0,0,0,0
18/9/2020,八,香園圍,出境,0,0,0,0
18/9/2020,八,港珠澳大橋,入境,75,11,3,89
18/9/2020,八,港珠澳大橋,出境,72,2,1,75
18/9/2020,八,落馬洲,入境,0,0,0,0
18/9/2020,八,落馬洲,出境,0,0,0,0
18/9/2020,八,文錦渡,入境,0,0,0,0
18/9/2020,八,文錦渡,出境,0,0,0,0
18/9/2020,八,沙頭角,入境,0,0,0,0
18/9/2020,八,沙頭角,出境,0,0,0,0
18/9/2020,八,深圳灣,入境,868,121,4,993
18/9/2020,八,深圳灣,出境,393,48,11,452
18/9/2020,八,中國客運碼頭,入境,0,0,0,0
18/9/2020,八,中國客運碼頭,出境,0,0,0,0
18/9/2020,八,港口管制,入境,0,0,0,0
18/9/2020,八,港口管制,出境,0,0,0,0
18/9/2020,八,啟德郵輪碼頭,入境,0,0,0,0
18/9/2020,八,啟德郵輪碼頭,出境,0,0,0,0
18/9/2020,八,港澳客輪碼頭,入境,0,0,0,0
18/9/2020,八,港澳客輪碼頭,出境,0,0,0,0
18/9/2020,八,屯門客運碼頭,入境,0,0,0,0
18/9/2020,八,屯門客運碼頭,出境,0,0,0,0
19/9/2020,八,機場,入境,1306,11,31,1348
19/9/2020,八,機場,出境,1544,25,36,1605
19/9/2020,八,高鐵西九龍,入境,0,0,0,0
19/9/2020,八,高鐵西九龍,出境,0,0,0,0
19/9/2020,八,紅磡,入境,0,0,0,0
19/9/2020,八,紅磡,出境,0,0,0,0
19/9/2020,八,羅湖,入境,0,0,0,0
19/9/2020,八,羅湖,出境,0,0,0,0
19/9/2020,八,落馬洲支線,入境,0,0,0,0
19/9/2020,八,落馬洲支線,出境,0,0,0,0
19/9/2020,八,香園圍,入境,0,0,0,0
19/9/2020,八,香園圍,出境,0,0,0,0
19/9/2020,八,港珠澳大橋,入境,114,9,4,127
19/9/2020,八,港珠澳大橋,出境,82,6,5,93
19/9/2020,八,落馬洲,入境,0,0,0,0
19/9/2020,八,落馬洲,出境,0,0,0,0
19/9/2020,八,文錦渡,入境,0,0,0,0
19/9/2020,八,文錦渡,出境,0,0,0,0
19/9/2020,八,沙頭角,入境,0,0,0,0
19/9/2020,八,沙頭角,出境,0,0,0,0
19/9/2020,八,深圳灣,入境,1236,202,4,1442
19/9/2020,八,深圳灣,出境,357,52,6,415
19/9/2020,八,中國客運碼頭,入境,0,0,0,0
19/9/2020,八,中國客運碼頭,出境,0,0,0,0
19/9/2020,八,港口管制,入境,0,0,0,0
19/9/2020,八,港口管制,出境,0,0,0,0
19/9/2020,八,啟德郵輪碼頭,入境,0,0,0,0
19/9/2020,八,啟德郵輪碼頭,出境,0,0,0,0
19/9/2020,八,港澳客輪碼頭,入境,0,0,0,0
19/9/2020,八,港澳客輪碼頭,出境,0,0,0,0
19/9/2020,八,屯門客運碼頭,入境,0,0,0,0
19/9/2020,八,屯門客運碼頭,出境,0,0,0,0
20/9/2020,八,機場,入境,1171,9,43,1223
20/9/2020,八,機場,出境,1292,21,48,1361
20/9/2020,八,高鐵西九龍,入境,0,0,0,0
20/9/2020,八,高鐵西九龍,出境,0,0,0,0
20/9/2020,八,紅磡,入境,0,0,0,0
20/9/2020,八,紅磡,出境,0,0,0,0
20/9/2020,八,羅湖,入境,0,0,0,0
20/9/2020,八,羅湖,出境,0,0,0,0
20/9/2020,八,落馬洲支線,入境,0,0,0,0
20/9/2020,八,落馬洲支線,出境,0,0,0,0
20/9/2020,八,香園圍,入境,0,0,0,0
20/9/2020,八,香園圍,出境,0,0,0,0
20/9/2020,八,港珠澳大橋,入境,144,16,5,165
20/9/2020,八,港珠澳大橋,出境,50,5,1,56
20/9/2020,八,落馬洲,入境,0,0,0,0
20/9/2020,八,落馬洲,出境,0,0,0,0
20/9/2020,八,文錦渡,入境,0,0,0,0
20/9/2020,八,文錦渡,出境,0,0,0,0
20/9/2020,八,沙頭角,入境,0,0,0,0
20/9/2020,八,沙頭角,出境,0,0,0,0
20/9/2020,八,深圳灣,入境,2339,314,9,2662
20/9/2020,八,深圳灣,出境,313,26,6,345
20/9/2020,八,中國客運碼頭,入境,0,0,0,0
20/9/2020,八,中國客運碼頭,出境,0,0,0,0
20/9/2020,八,港口管制,入境,0,0,0,0
20/9/2020,八,港口管制,出境,0,0,0,0
20/9/2020,八,啟德郵輪碼頭,入境,0,0,0,0
20/9/2020,八,啟德郵輪碼頭,出境,0,0,0,0
20/9/2020,八,港澳客輪碼頭,入境,0,0,0,0
20/9/2020,八,港澳客輪碼頭,出境,0,0,0,0
20/9/2020,八,屯門客運碼頭,入境,0,0,0,0
20/9/2020,八,屯門客運碼頭,出境,0,0,0,0
21/9/2020,八,機場,入境,740,1,17,758
20/9/2020,八,機場,出境,1110,5,23,1138
21/9/2020,八,高鐵西九龍,入境,0,0,0,0
21/9/2020,八,高鐵西九龍,出境,0,0,0,0
21/9/2020,八,紅磡,入境,0,0,0,0
21/9/2020,八,紅磡,出境,0,0,0,0
21/9/2020,八,羅湖,入境,0,0,0,0
21/9/2020,八,羅湖,出境,0,0,0,0
21/9/2020,八,落馬洲支線,入境,0,0,0,0
21/9/2020,八,落馬洲支線,出境,0,0,0,0
21/9/2020,八,香園圍,入境,0,0,0,0
21/9/2020,八,香園圍,出境,0,0,0,0
21/9/2020,八,港珠澳大橋,入境,119,9,1,129
21/9/2020,八,港珠澳大橋,出境,44,1,3,48
21/9/2020,八,落馬洲,入境,0,0,0,0
21/9/2020,八,落馬洲,出境,0,0,0,0
21/9/2020,八,文錦渡,入境,0,0,0,0
21/9/2020,八,文錦渡,出境,0,0,0,0
21/9/2020,八,沙頭角,入境,0,0,0,0
21/9/2020,八,沙頭角,出境,0,0,0,0
21/9/2020,八,深圳灣,入境,1398,204,3,1605
21/9/2020,八,深圳灣,出境,296,39,3,338
21/9/2020,八,中國客運碼頭,入境,0,0,0,0
21/9/2020,八,中國客運碼頭,出境,0,0,0,0
21/9/2020,八,港口管制,入境,0,0,0,0
21/9/2020,八,港口管制,出境,0,0,0,0
21/9/2020,八,啟德郵輪碼頭,入境,0,0,0,0
21/9/2020,八,啟德郵輪碼頭,出境,0,0,0,0
21/9/2020,八,港澳客輪碼頭,入境,0,0,0,0
21/9/2020,八,港澳客輪碼頭,出境,0,0,0,0
21/9/2020,八,屯門客運碼頭,入境,0,0,0,0
21/9/2020,八,屯門客運碼頭,出境,0,0,0,0
22/9/2020,八,機場,入境,740,2,21,763
22/9/2020,八,機場,出境,1109,22,57,1188
22/9/2020,八,高鐵西九龍,入境,0,0,0,0
22/9/2020,八,高鐵西九龍,出境,0,0,0,0
22/9/2020,八,紅磡,入境,0,0,0,0
22/9/2020,八,紅磡,出境,0,0,0,0
22/9/2020,八,羅湖,入境,0,0,0,0
22/9/2020,八,羅湖,出境,0,0,0,0
22/9/2020,八,落馬洲支線,入境,0,0,0,0
22/9/2020,八,落馬洲支線,出境,0,0,0,0
22/9/2020,八,香園圍,入境,0,0,0,0
22/9/2020,八,香園圍,出境,0,0,0,0
22/9/2020,八,港珠澳大橋,入境,104,5,2,111
22/9/2020,八,港珠澳大橋,出境,102,6,1,109
22/9/2020,八,落馬洲,入境,0,0,0,0
22/9/2020,八,落馬洲,出境,0,0,0,0
22/9/2020,八,文錦渡,入境,0,0,0,0
22/9/2020,八,文錦渡,出境,0,0,0,0
22/9/2020,八,沙頭角,入境,0,0,0,0
22/9/2020,八,沙頭角,出境,0,0,0,0
22/9/2020,八,深圳灣,入境,950,129,3,1082
22/9/2020,八,深圳灣,出境,373,32,7,412
22/9/2020,八,中國客運碼頭,入境,0,0,0,0
22/9/2020,八,中國客運碼頭,出境,0,0,0,0
22/9/2020,八,港口管制,入境,0,0,0,0
22/9/2020,八,港口管制,出境,0,0,0,0
22/9/2020,八,啟德郵輪碼頭,入境,0,0,0,0
22/9/2020,八,啟德郵輪碼頭,出境,0,0,0,0
22/9/2020,八,港澳客輪碼頭,入境,0,0,0,0
22/9/2020,八,港澳客輪碼頭,出境,0,0,0,0
22/9/2020,八,屯門客運碼頭,入境,0,0,0,0
22/9/2020,八,屯門客運碼頭,出境,0,0,0,0
23/9/2020,八,機場,入境,884,1,39,924
23/9/2020,八,機場,出境,891,11,60,962
23/9/2020,八,高鐵西九龍,入境,0,0,0,0
23/9/2020,八,高鐵西九龍,出境,0,0,0,0
23/9/2020,八,紅磡,入境,0,0,0,0
23/9/2020,八,紅磡,出境,0,0,0,0
23/9/2020,八,羅湖,入境,0,0,0,0
23/9/2020,八,羅湖,出境,0,0,0,0
23/9/2020,八,落馬洲支線,入境,0,0,0,0
23/9/2020,八,落馬洲支線,出境,0,0,0,0
23/9/2020,八,香園圍,入境,0,0,0,0
23/9/2020,八,香園圍,出境,0,0,0,0
23/9/2020,八,港珠澳大橋,入境,88,6,4,98
23/9/2020,八,港珠澳大橋,出境,175,5,1,181
23/9/2020,八,落馬洲,入境,0,0,0,0
23/9/2020,八,落馬洲,出境,0,0,0,0
23/9/2020,八,文錦渡,入境,0,0,0,0
23/9/2020,八,文錦渡,出境,0,0,0,0
23/9/2020,八,沙頭角,入境,0,0,0,0
23/9/2020,八,沙頭角,出境,0,0,0,0
23/9/2020,八,深圳灣,入境,878,141,6,1025
23/9/2020,八,深圳灣,出境,573,80,8,661
23/9/2020,八,中國客運碼頭,入境,0,0,0,0
23/9/2020,八,中國客運碼頭,出境,0,0,0,0
23/9/2020,八,港口管制,入境,0,0,0,0
23/9/2020,八,港口管制,出境,0,0,0,0
23/9/2020,八,啟德郵輪碼頭,入境,0,0,0,0
23/9/2020,八,啟德郵輪碼頭,出境,0,0,0,0
23/9/2020,八,港澳客輪碼頭,入境,0,0,0,0
23/9/2020,八,港澳客輪碼頭,出境,0,0,0,0
23/9/2020,八,屯門客運碼頭,入境,0,0,0,0
23/9/2020,八,屯門客運碼頭,出境,0,0,0,0
24/9/2020,八,機場,入境,604,3,14,621
24/9/2020,八,機場,出境,1255,6,37,1298
24/9/2020,八,高鐵西九龍,入境,0,0,0,0
24/9/2020,八,高鐵西九龍,出境,0,0,0,0
24/9/2020,八,紅磡,入境,0,0,0,0
24/9/2020,八,紅磡,出境,0,0,0,0
24/9/2020,八,羅湖,入境,0,0,0,0
24/9/2020,八,羅湖,出境,0,0,0,0
24/9/2020,八,落馬洲支線,入境,0,0,0,0
24/9/2020,八,落馬洲支線,出境,0,0,0,0
24/9/2020,八,香園圍,入境,0,0,0,0
24/9/2020,八,香園圍,出境,0,0,0,0
24/9/2020,八,港珠澳大橋,入境,103,6,3,112
24/9/2020,八,港珠澳大橋,出境,110,4,0,114
24/9/2020,八,落馬洲,入境,0,0,0,0
24/9/2020,八,落馬洲,出境,0,0,0,0
24/9/2020,八,文錦渡,入境,0,0,0,0
24/9/2020,八,文錦渡,出境,0,0,0,0
24/9/2020,八,沙頭角,入境,0,0,0,0
24/9/2020,八,沙頭角,出境,0,0,0,0
24/9/2020,八,深圳灣,入境,769,119,5,893
24/9/2020,八,深圳灣,出境,495,61,7,563
24/9/2020,八,中國客運碼頭,入境,0,0,0,0
24/9/2020,八,中國客運碼頭,出境,0,0,0,0
24/9/2020,八,港口管制,入境,0,0,0,0
24/9/2020,八,港口管制,出境,0,0,0,0
24/9/2020,八,啟德郵輪碼頭,入境,0,0,0,0
24/9/2020,八,啟德郵輪碼頭,出境,0,0,0,0
24/9/2020,八,港澳客輪碼頭,入境,0,0,0,0
24/9/2020,八,港澳客輪碼頭,出境,0,0,0,0
24/9/2020,八,屯門客運碼頭,入境,0,0,0,0
24/9/2020,八,屯門客運碼頭,出境,0,0,0,0
25/9/2020,八,機場,入境,885,3,42,930
25/9/2020,八,機場,出境,1358,13,51,1422
25/9/2020,八,高鐵西九龍,入境,0,0,0,0
25/9/2020,八,高鐵西九龍,出境,0,0,0,0
25/9/2020,八,紅磡,入境,0,0,0,0
25/9/2020,八,紅磡,出境,0,0,0,0
25/9/2020,八,羅湖,入境,0,0,0,0
25/9/2020,八,羅湖,出境,0,0,0,0
25/9/2020,八,落馬洲支線,入境,0,0,0,0
25/9/2020,八,落馬洲支線,出境,0,0,0,0
25/9/2020,八,香園圍,入境,0,0,0,0
25/9/2020,八,香園圍,出境,0,0,0,0
25/9/2020,八,港珠澳大橋,入境,122,3,1,126
25/9/2020,八,港珠澳大橋,出境,161,5,0,166
25/9/2020,八,落馬洲,入境,0,0,0,0
25/9/2020,八,落馬洲,出境,0,0,0,0
25/9/2020,八,文錦渡,入境,0,0,0,0
25/9/2020,八,文錦渡,出境,0,0,0,0
25/9/2020,八,沙頭角,入境,0,0,0,0
25/9/2020,八,沙頭角,出境,0,0,0,0
25/9/2020,八,深圳灣,入境,965,129,6,1100
25/9/2020,八,深圳灣,出境,513,71,5,589
25/9/2020,八,中國客運碼頭,入境,0,0,0,0
25/9/2020,八,中國客運碼頭,出境,0,0,0,0
25/9/2020,八,港口管制,入境,0,0,0,0
25/9/2020,八,港口管制,出境,0,0,0,0
25/9/2020,八,啟德郵輪碼頭,入境,0,0,0,0
25/9/2020,八,啟德郵輪碼頭,出境,0,0,0,0
25/9/2020,八,港澳客輪碼頭,入境,0,0,0,0
25/9/2020,八,港澳客輪碼頭,出境,0,0,0,0
25/9/2020,八,屯門客運碼頭,入境,0,0,0,0
25/9/2020,八,屯門客運碼頭,出境,0,0,0,0
26/9/2020,八,機場,入境,1100,18,12,1130
26/9/2020,八,機場,出境,1382,47,27,1456
26/9/2020,八,高鐵西九龍,入境,0,0,0,0
26/9/2020,八,高鐵西九龍,出境,0,0,0,0
26/9/2020,八,紅磡,入境,0,0,0,0
26/9/2020,八,紅磡,出境,0,0,0,0
26/9/2020,八,羅湖,入境,0,0,0,0
26/9/2020,八,羅湖,出境,0,0,0,0
26/9/2020,八,落馬洲支線,入境,0,0,0,0
26/9/2020,八,落馬洲支線,出境,0,0,0,0
26/9/2020,八,香園圍,入境,0,0,0,0
26/9/2020,八,香園圍,出境,0,0,0,0
26/9/2020,八,港珠澳大橋,入境,87,9,1,97
26/9/2020,八,港珠澳大橋,出境,83,7,1,91
26/9/2020,八,落馬洲,入境,0,0,0,0
26/9/2020,八,落馬洲,出境,0,0,0,0
26/9/2020,八,文錦渡,入境,0,0,0,0
26/9/2020,八,文錦渡,出境,0,0,0,0
26/9/2020,八,沙頭角,入境,0,0,0,0
26/9/2020,八,沙頭角,出境,0,0,0,0
26/9/2020,八,深圳灣,入境,1003,128,5,1136
26/9/2020,八,深圳灣,出境,489,80,5,574
26/9/2020,八,中國客運碼頭,入境,0,0,0,0
26/9/2020,八,中國客運碼頭,出境,0,0,0,0
26/9/2020,八,港口管制,入境,0,0,0,0
26/9/2020,八,港口管制,出境,0,0,0,0
26/9/2020,八,啟德郵輪碼頭,入境,0,0,0,0
26/9/2020,八,啟德郵輪碼頭,出境,0,0,0,0
26/9/2020,八,港澳客輪碼頭,入境,0,0,0,0
26/9/2020,八,港澳客輪碼頭,出境,0,0,0,0
26/9/2020,八,屯門客運碼頭,入境,0,0,0,0
26/9/2020,八,屯門客運碼頭,出境,0,0,0,0
27/9/2020,八,機場,入境,1315,3,37,1355
27/9/2020,八,機場,出境,1213,8,52,1273
27/9/2020,八,高鐵西九龍,入境,0,0,0,0
27/9/2020,八,高鐵西九龍,出境,0,0,0,0
27/9/2020,八,紅磡,入境,0,0,0,0
27/9/2020,八,紅磡,出境,0,0,0,0
27/9/2020,八,羅湖,入境,0,0,0,0
27/9/2020,八,羅湖,出境,0,0,0,0
27/9/2020,八,落馬洲支線,入境,0,0,0,0
27/9/2020,八,落馬洲支線,出境,0,0,0,0
27/9/2020,八,香園圍,入境,0,0,0,0
27/9/2020,八,香園圍,出境,0,0,0,0
27/9/2020,八,港珠澳大橋,入境,51,5,2,58
27/9/2020,八,港珠澳大橋,出境,51,2,0,53
27/9/2020,八,落馬洲,入境,0,0,0,0
27/9/2020,八,落馬洲,出境,0,0,0,0
27/9/2020,八,文錦渡,入境,0,0,0,0
27/9/2020,八,文錦渡,出境,0,0,0,0
27/9/2020,八,沙頭角,入境,0,0,0,0
27/9/2020,八,沙頭角,出境,0,0,0,0
27/9/2020,八,深圳灣,入境,1073,147,4,1224
27/9/2020,八,深圳灣,出境,308,40,9,357
27/9/2020,八,中國客運碼頭,入境,0,0,0,0
27/9/2020,八,中國客運碼頭,出境,0,0,0,0
27/9/2020,八,港口管制,入境,0,0,0,0
27/9/2020,八,港口管制,出境,0,0,0,0
27/9/2020,八,啟德郵輪碼頭,入境,0,0,0,0
27/9/2020,八,啟德郵輪碼頭,出境,0,0,0,0
27/9/2020,八,港澳客輪碼頭,入境,0,0,0,0
27/9/2020,八,港澳客輪碼頭,出境,0,0,0,0
27/9/2020,八,屯門客運碼頭,入境,0,0,0,0
27/9/2020,八,屯門客運碼頭,出境,0,0,0,0
28/9/2020,八,機場,入境,965,4,35,1004
28/9/2020,八,機場,出境,1019,12,40,1071
28/9/2020,八,高鐵西九龍,入境,0,0,0,0
28/9/2020,八,高鐵西九龍,出境,0,0,0,0
28/9/2020,八,紅磡,入境,0,0,0,0
28/9/2020,八,紅磡,出境,0,0,0,0
28/9/2020,八,羅湖,入境,0,0,0,0
28/9/2020,八,羅湖,出境,0,0,0,0
28/9/2020,八,落馬洲支線,入境,0,0,0,0
28/9/2020,八,落馬洲支線,出境,0,0,0,0
28/9/2020,八,香園圍,入境,0,0,0,0
28/9/2020,八,香園圍,出境,0,0,0,0
28/9/2020,八,港珠澳大橋,入境,52,4,1,57
28/9/2020,八,港珠澳大橋,出境,49,6,3,58
28/9/2020,八,落馬洲,入境,0,0,0,0
28/9/2020,八,落馬洲,出境,0,0,0,0
28/9/2020,八,文錦渡,入境,0,0,0,0
28/9/2020,八,文錦渡,出境,0,0,0,0
28/9/2020,八,沙頭角,入境,0,0,0,0
28/9/2020,八,沙頭角,出境,0,0,0,0
28/9/2020,八,深圳灣,入境,882,116,5,1003
28/9/2020,八,深圳灣,出境,426,31,9,466
28/9/2020,八,中國客運碼頭,入境,0,0,0,0
28/9/2020,八,中國客運碼頭,出境,0,0,0,0
28/9/2020,八,港口管制,入境,0,0,0,0
28/9/2020,八,港口管制,出境,0,0,0,0
28/9/2020,八,啟德郵輪碼頭,入境,0,0,0,0
28/9/2020,八,啟德郵輪碼頭,出境,0,0,0,0
28/9/2020,八,港澳客輪碼頭,入境,0,0,0,0
28/9/2020,八,港澳客輪碼頭,出境,0,0,0,0
28/9/2020,八,屯門客運碼頭,入境,0,0,0,0
28/9/2020,八,屯門客運碼頭,出境,0,0,0,0
29/9/2020,八,機場,入境,1224,11,30,1265
29/9/2020,八,機場,出境,1303,20,75,1398
29/9/2020,八,高鐵西九龍,入境,0,0,0,0
29/9/2020,八,高鐵西九龍,出境,0,0,0,0
29/9/2020,八,紅磡,入境,0,0,0,0
29/9/2020,八,紅磡,出境,0,0,0,0
29/9/2020,八,羅湖,入境,0,0,0,0
29/9/2020,八,羅湖,出境,0,0,0,0
29/9/2020,八,落馬洲支線,入境,0,0,0,0
29/9/2020,八,落馬洲支線,出境,0,0,0,0
29/9/2020,八,香園圍,入境,0,0,0,0
29/9/2020,八,香園圍,出境,0,0,0,0
29/9/2020,八,港珠澳大橋,入境,81,6,5,92
29/9/2020,八,港珠澳大橋,出境,78,3,8,89
29/9/2020,八,落馬洲,入境,0,0,0,0
29/9/2020,八,落馬洲,出境,0,0,0,0
29/9/2020,八,文錦渡,入境,0,0,0,0
29/9/2020,八,文錦渡,出境,0,0,0,0
29/9/2020,八,沙頭角,入境,0,0,0,0
29/9/2020,八,沙頭角,出境,0,0,0,0
29/9/2020,八,深圳灣,入境,1010,124,4,1138
29/9/2020,八,深圳灣,出境,411,48,4,463
29/9/2020,八,中國客運碼頭,入境,0,0,0,0
29/9/2020,八,中國客運碼頭,出境,0,0,0,0
29/9/2020,八,港口管制,入境,0,0,0,0
29/9/2020,八,港口管制,出境,0,0,0,0
29/9/2020,八,啟德郵輪碼頭,入境,0,0,0,0
29/9/2020,八,啟德郵輪碼頭,出境,0,0,0,0
29/9/2020,八,港澳客輪碼頭,入境,0,0,0,0
29/9/2020,八,港澳客輪碼頭,出境,0,0,0,0
29/9/2020,八,屯門客運碼頭,入境,0,0,0,0
29/9/2020,八,屯門客運碼頭,出境,0,0,0,0
30/9/2020,八,機場,入境,1678,3,28,1709
30/9/2020,八,機場,出境,992,18,49,1059
30/9/2020,八,高鐵西九龍,入境,0,0,0,0
30/9/2020,八,高鐵西九龍,出境,0,0,0,0
30/9/2020,八,紅磡,入境,0,0,0,0
30/9/2020,八,紅磡,出境,0,0,0,0
30/9/2020,八,羅湖,入境,0,0,0,0
30/9/2020,八,羅湖,出境,0,0,0,0
30/9/2020,八,落馬洲支線,入境,0,0,0,0
30/9/2020,八,落馬洲支線,出境,0,0,0,0
30/9/2020,八,香園圍,入境,0,0,0,0
30/9/2020,八,香園圍,出境,0,0,0,0
30/9/2020,八,港珠澳大橋,入境,133,5,8,146
30/9/2020,八,港珠澳大橋,出境,88,7,2,97
30/9/2020,八,落馬洲,入境,0,0,0,0
30/9/2020,八,落馬洲,出境,0,0,0,0
30/9/2020,八,文錦渡,入境,0,0,0,0
30/9/2020,八,文錦渡,出境,0,0,0,0
30/9/2020,八,沙頭角,入境,0,0,0,0
30/9/2020,八,沙頭角,出境,0,0,0,0
30/9/2020,八,深圳灣,入境,1201,141,6,1348
30/9/2020,八,深圳灣,出境,667,79,22,768
30/9/2020,八,中國客運碼頭,入境,0,0,0,0
30/9/2020,八,中國客運碼頭,出境,0,0,0,0
30/9/2020,八,港口管制,入境,0,0,0,0
30/9/2020,八,港口管制,出境,0,0,0,0
30/9/2020,八,啟德郵輪碼頭,入境,0,0,0,0
30/9/2020,八,啟德郵輪碼頭,出境,0,0,0,0
30/9/2020,八,港澳客輪碼頭,入境,0,0,0,0
30/9/2020,八,港澳客輪碼頭,出境,0,0,0,0
30/9/2020,八,屯門客運碼頭,入境,0,0,0,0
30/9/2020,八,屯門客運碼頭,出境,0,0,0,0
1/10/2020,九+十,機場,入境,898,4,34,936
1/10/2020,九+十,機場,出境,1147,5,101,1253
1/10/2020,九+十,高鐵西九龍,入境,0,0,0,0
1/10/2020,九+十,高鐵西九龍,出境,0,0,0,0
1/10/2020,九+十,紅磡,入境,0,0,0,0
1/10/2020,九+十,紅磡,出境,0,0,0,0
1/10/2020,九+十,羅湖,入境,0,0,0,0
1/10/2020,九+十,羅湖,出境,0,0,0,0
1/10/2020,九+十,落馬洲支線,入境,0,0,0,0
1/10/2020,九+十,落馬洲支線,出境,0,0,0,0
1/10/2020,九+十,香園圍,入境,0,0,0,0
1/10/2020,九+十,香園圍,出境,0,0,0,0
1/10/2020,九+十,港珠澳大橋,入境,58,4,76,138
1/10/2020,九+十,港珠澳大橋,出境,80,10,2,92
1/10/2020,九+十,落馬洲,入境,0,0,0,0
1/10/2020,九+十,落馬洲,出境,0,0,0,0
1/10/2020,九+十,文錦渡,入境,0,0,0,0
1/10/2020,九+十,文錦渡,出境,0,0,0,0
1/10/2020,九+十,沙頭角,入境,0,0,0,0
1/10/2020,九+十,沙頭角,出境,0,0,0,0
1/10/2020,九+十,深圳灣,入境,570,85,8,663
1/10/2020,九+十,深圳灣,出境,403,46,3,452
1/10/2020,九+十,中國客運碼頭,入境,0,0,0,0
1/10/2020,九+十,中國客運碼頭,出境,0,0,0,0
1/10/2020,九+十,港口管制,入境,0,0,0,0
1/10/2020,九+十,港口管制,出境,0,0,0,0
1/10/2020,九+十,啟德郵輪碼頭,入境,0,0,0,0
1/10/2020,九+十,啟德郵輪碼頭,出境,0,0,0,0
1/10/2020,九+十,港澳客輪碼頭,入境,0,0,0,0
1/10/2020,九+十,港澳客輪碼頭,出境,0,0,0,0
1/10/2020,九+十,屯門客運碼頭,入境,0,0,0,0
1/10/2020,九+十,屯門客運碼頭,出境,0,0,0,0
2/10/2020,九+十,機場,入境,677,4,43,724
2/10/2020,九+十,機場,出境,960,19,66,1045
2/10/2020,九+十,高鐵西九龍,入境,0,0,0,0
2/10/2020,九+十,高鐵西九龍,出境,0,0,0,0
2/10/2020,九+十,紅磡,入境,0,0,0,0
2/10/2020,九+十,紅磡,出境,0,0,0,0
2/10/2020,九+十,羅湖,入境,0,0,0,0
2/10/2020,九+十,羅湖,出境,0,0,0,0
2/10/2020,九+十,落馬洲支線,入境,0,0,0,0
2/10/2020,九+十,落馬洲支線,出境,0,0,0,0
2/10/2020,九+十,香園圍,入境,0,0,0,0
2/10/2020,九+十,香園圍,出境,0,0,0,0
2/10/2020,九+十,港珠澳大橋,入境,54,0,5,59
2/10/2020,九+十,港珠澳大橋,出境,48,3,1,52
2/10/2020,九+十,落馬洲,入境,0,0,0,0
2/10/2020,九+十,落馬洲,出境,0,0,0,0
2/10/2020,九+十,文錦渡,入境,0,0,0,0
2/10/2020,九+十,文錦渡,出境,0,0,0,0
2/10/2020,九+十,沙頭角,入境,0,0,0,0
2/10/2020,九+十,沙頭角,出境,0,0,0,0
2/10/2020,九+十,深圳灣,入境,946,150,2,1098
2/10/2020,九+十,深圳灣,出境,388,60,6,454
2/10/2020,九+十,中國客運碼頭,入境,0,0,0,0
2/10/2020,九+十,中國客運碼頭,出境,0,0,0,0
2/10/2020,九+十,港口管制,入境,0,0,0,0
2/10/2020,九+十,港口管制,出境,0,0,0,0
2/10/2020,九+十,啟德郵輪碼頭,入境,0,0,0,0
2/10/2020,九+十,啟德郵輪碼頭,出境,0,0,0,0
2/10/2020,九+十,港澳客輪碼頭,入境,0,0,0,0
2/10/2020,九+十,港澳客輪碼頭,出境,0,0,0,0
2/10/2020,九+十,屯門客運碼頭,入境,0,0,0,0
2/10/2020,九+十,屯門客運碼頭,出境,0,0,0,0
3/10/2020,九+十,機場,入境,760,4,19,783
3/10/2020,九+十,機場,出境,1051,21,58,1130
3/10/2020,九+十,高鐵西九龍,入境,0,0,0,0
3/10/2020,九+十,高鐵西九龍,出境,0,0,0,0
3/10/2020,九+十,紅磡,入境,0,0,0,0
3/10/2020,九+十,紅磡,出境,0,0,0,0
3/10/2020,九+十,羅湖,入境,0,0,0,0
3/10/2020,九+十,羅湖,出境,0,0,0,0
3/10/2020,九+十,落馬洲支線,入境,0,0,0,0
3/10/2020,九+十,落馬洲支線,出境,0,0,0,0
3/10/2020,九+十,香園圍,入境,0,0,0,0
3/10/2020,九+十,香園圍,出境,0,0,0,0
3/10/2020,九+十,港珠澳大橋,入境,54,12,5,71
3/10/2020,九+十,港珠澳大橋,出境,35,2,2,39
3/10/2020,九+十,落馬洲,入境,0,0,0,0
3/10/2020,九+十,落馬洲,出境,0,0,0,0
3/10/2020,九+十,文錦渡,入境,0,0,0,0
3/10/2020,九+十,文錦渡,出境,0,0,0,0
3/10/2020,九+十,沙頭角,入境,0,0,0,0
3/10/2020,九+十,沙頭角,出境,0,0,0,0
3/10/2020,九+十,深圳灣,入境,937,170,6,1113
3/10/2020,九+十,深圳灣,出境,182,31,3,216
3/10/2020,九+十,中國客運碼頭,入境,0,0,0,0
3/10/2020,九+十,中國客運碼頭,出境,0,0,0,0
3/10/2020,九+十,港口管制,入境,0,0,0,0
3/10/2020,九+十,港口管制,出境,0,0,0,0
3/10/2020,九+十,啟德郵輪碼頭,入境,0,0,0,0
3/10/2020,九+十,啟德郵輪碼頭,出境,0,0,0,0
3/10/2020,九+十,港澳客輪碼頭,入境,0,0,0,0
3/10/2020,九+十,港澳客輪碼頭,出境,0,0,0,0
3/10/2020,九+十,屯門客運碼頭,入境,0,0,0,0
3/10/2020,九+十,屯門客運碼頭,出境,0,0,0,0
4/10/2020,九+十,機場,入境,1030,3,59,1092
4/10/2020,九+十,機場,出境,846,8,44,898
4/10/2020,九+十,高鐵西九龍,入境,0,0,0,0
4/10/2020,九+十,高鐵西九龍,出境,0,0,0,0
4/10/2020,九+十,紅磡,入境,0,0,0,0
4/10/2020,九+十,紅磡,出境,0,0,0,0
4/10/2020,九+十,羅湖,入境,0,0,0,0
4/10/2020,九+十,羅湖,出境,0,0,0,0
4/10/2020,九+十,落馬洲支線,入境,0,0,0,0
4/10/2020,九+十,落馬洲支線,出境,0,0,0,0
4/10/2020,九+十,香園圍,入境,0,0,0,0
4/10/2020,九+十,香園圍,出境,0,0,0,0
4/10/2020,九+十,港珠澳大橋,入境,77,10,4,91
4/10/2020,九+十,港珠澳大橋,出境,60,5,3,68
4/10/2020,九+十,落馬洲,入境,0,0,0,0
4/10/2020,九+十,落馬洲,出境,0,0,0,0
4/10/2020,九+十,文錦渡,入境,0,0,0,0
4/10/2020,九+十,文錦渡,出境,0,0,0,0
4/10/2020,九+十,沙頭角,入境,0,0,0,0
4/10/2020,九+十,沙頭角,出境,0,0,0,0
4/10/2020,九+十,深圳灣,入境,1290,212,9,1511
4/10/2020,九+十,深圳灣,出境,320,49,9,378
4/10/2020,九+十,中國客運碼頭,入境,0,0,0,0
4/10/2020,九+十,中國客運碼頭,出境,0,0,0,0
4/10/2020,九+十,港口管制,入境,0,0,0,0
4/10/2020,九+十,港口管制,出境,0,0,0,0
4/10/2020,九+十,啟德郵輪碼頭,入境,0,0,0,0
4/10/2020,九+十,啟德郵輪碼頭,出境,0,0,0,0
4/10/2020,九+十,港澳客輪碼頭,入境,0,0,0,0
4/10/2020,九+十,港澳客輪碼頭,出境,0,0,0,0
4/10/2020,九+十,屯門客運碼頭,入境,0,0,0,0
4/10/2020,九+十,屯門客運碼頭,出境,0,0,0,0
5/10/2020,九+十,機場,入境,731,2,33,766
5/10/2020,九+十,機場,出境,717,13,34,764
5/10/2020,九+十,高鐵西九龍,入境,0,0,0,0
5/10/2020,九+十,高鐵西九龍,出境,0,0,0,0
5/10/2020,九+十,紅磡,入境,0,0,0,0
5/10/2020,九+十,紅磡,出境,0,0,0,0
5/10/2020,九+十,羅湖,入境,0,0,0,0
5/10/2020,九+十,羅湖,出境,0,0,0,0
5/10/2020,九+十,落馬洲支線,入境,0,0,0,0
5/10/2020,九+十,落馬洲支線,出境,0,0,0,0
5/10/2020,九+十,香園圍,入境,0,0,0,0
5/10/2020,九+十,香園圍,出境,0,0,0,0
5/10/2020,九+十,港珠澳大橋,入境,78,4,4,86
5/10/2020,九+十,港珠澳大橋,出境,98,14,5,117
5/10/2020,九+十,落馬洲,入境,0,0,0,0
5/10/2020,九+十,落馬洲,出境,0,0,0,0
5/10/2020,九+十,文錦渡,入境,0,0,0,0
5/10/2020,九+十,文錦渡,出境,0,0,0,0
5/10/2020,九+十,沙頭角,入境,0,0,0,0
5/10/2020,九+十,沙頭角,出境,0,0,0,0
5/10/2020,九+十,深圳灣,入境,927,137,2,1066
5/10/2020,九+十,深圳灣,出境,450,77,6,533
5/10/2020,九+十,中國客運碼頭,入境,0,0,0,0
5/10/2020,九+十,中國客運碼頭,出境,0,0,0,0
5/10/2020,九+十,港口管制,入境,0,0,0,0
5/10/2020,九+十,港口管制,出境,0,0,0,0
5/10/2020,九+十,啟德郵輪碼頭,入境,0,0,0,0
5/10/2020,九+十,啟德郵輪碼頭,出境,0,0,0,0
5/10/2020,九+十,港澳客輪碼頭,入境,0,0,0,0
5/10/2020,九+十,港澳客輪碼頭,出境,0,0,0,0
5/10/2020,九+十,屯門客運碼頭,入境,0,0,0,0
5/10/2020,九+十,屯門客運碼頭,出境,0,0,0,0
6/10/2020,九+十,機場,入境,701,4,24,729
6/10/2020,九+十,機場,出境,823,23,29,875
6/10/2020,九+十,高鐵西九龍,入境,0,0,0,0
6/10/2020,九+十,高鐵西九龍,出境,0,0,0,0
6/10/2020,九+十,紅磡,入境,0,0,0,0
6/10/2020,九+十,紅磡,出境,0,0,0,0
6/10/2020,九+十,羅湖,入境,0,0,0,0
6/10/2020,九+十,羅湖,出境,0,0,0,0
6/10/2020,九+十,落馬洲支線,入境,0,0,0,0
6/10/2020,九+十,落馬洲支線,出境,0,0,0,0
6/10/2020,九+十,香園圍,入境,0,0,0,0
6/10/2020,九+十,香園圍,出境,0,0,0,0
6/10/2020,九+十,港珠澳大橋,入境,66,3,1,70
6/10/2020,九+十,港珠澳大橋,出境,160,7,0,167
6/10/2020,九+十,落馬洲,入境,0,0,0,0
6/10/2020,九+十,落馬洲,出境,0,0,0,0
6/10/2020,九+十,文錦渡,入境,0,0,0,0
6/10/2020,九+十,文錦渡,出境,0,0,0,0
6/10/2020,九+十,沙頭角,入境,0,0,0,0
6/10/2020,九+十,沙頭角,出境,0,0,0,0
6/10/2020,九+十,深圳灣,入境,821,86,5,912
6/10/2020,九+十,深圳灣,出境,733,86,6,825
6/10/2020,九+十,中國客運碼頭,入境,0,0,0,0
6/10/2020,九+十,中國客運碼頭,出境,0,0,0,0
6/10/2020,九+十,港口管制,入境,0,0,0,0
6/10/2020,九+十,港口管制,出境,0,0,0,0
6/10/2020,九+十,啟德郵輪碼頭,入境,0,0,0,0
6/10/2020,九+十,啟德郵輪碼頭,出境,0,0,0,0
6/10/2020,九+十,港澳客輪碼頭,入境,0,0,0,0
6/10/2020,九+十,港澳客輪碼頭,出境,0,0,0,0
6/10/2020,九+十,屯門客運碼頭,入境,0,0,0,0
6/10/2020,九+十,屯門客運碼頭,出境,0,0,0,0
7/10/2020,九+十,機場,入境,525,1,26,552
7/10/2020,九+十,機場,出境,621,11,38,670
7/10/2020,九+十,高鐵西九龍,入境,0,0,0,0
7/10/2020,九+十,高鐵西九龍,出境,0,0,0,0
7/10/2020,九+十,紅磡,入境,0,0,0,0
7/10/2020,九+十,紅磡,出境,0,0,0,0
7/10/2020,九+十,羅湖,入境,0,0,0,0
7/10/2020,九+十,羅湖,出境,0,0,0,0
7/10/2020,九+十,落馬洲支線,入境,0,0,0,0
7/10/2020,九+十,落馬洲支線,出境,0,0,0,0
7/10/2020,九+十,香園圍,入境,0,0,0,0
7/10/2020,九+十,香園圍,出境,0,0,0,0
7/10/2020,九+十,港珠澳大橋,入境,74,7,6,87
7/10/2020,九+十,港珠澳大橋,出境,158,5,4,167
7/10/2020,九+十,落馬洲,入境,0,0,0,0
7/10/2020,九+十,落馬洲,出境,0,0,0,0
7/10/2020,九+十,文錦渡,入境,0,0,0,0
7/10/2020,九+十,文錦渡,出境,0,0,0,0
7/10/2020,九+十,沙頭角,入境,0,0,0,0
7/10/2020,九+十,沙頭角,出境,0,0,0,0
7/10/2020,九+十,深圳灣,入境,602,77,3,682
7/10/2020,九+十,深圳灣,出境,998,171,7,1176
7/10/2020,九+十,中國客運碼頭,入境,0,0,0,0
7/10/2020,九+十,中國客運碼頭,出境,0,0,0,0
7/10/2020,九+十,港口管制,入境,0,0,0,0
7/10/2020,九+十,港口管制,出境,0,0,0,0
7/10/2020,九+十,啟德郵輪碼頭,入境,0,0,0,0
7/10/2020,九+十,啟德郵輪碼頭,出境,0,0,0,0
7/10/2020,九+十,港澳客輪碼頭,入境,0,0,0,0
7/10/2020,九+十,港澳客輪碼頭,出境,0,0,0,0
7/10/2020,九+十,屯門客運碼頭,入境,0,0,0,0
7/10/2020,九+十,屯門客運碼頭,出境,0,0,0,0
8/10/2020,九+十,機場,入境,798,1,35,834
8/10/2020,九+十,機場,出境,932,6,53,991
8/10/2020,九+十,高鐵西九龍,入境,0,0,0,0
8/10/2020,九+十,高鐵西九龍,出境,0,0,0,0
8/10/2020,九+十,紅磡,入境,0,0,0,0
8/10/2020,九+十,紅磡,出境,0,0,0,0
8/10/2020,九+十,羅湖,入境,0,0,0,0
8/10/2020,九+十,羅湖,出境,0,0,0,0
8/10/2020,九+十,落馬洲支線,入境,0,0,0,0
8/10/2020,九+十,落馬洲支線,出境,0,0,0,0
8/10/2020,九+十,香園圍,入境,0,0,0,0
8/10/2020,九+十,香園圍,出境,0,0,0,0
8/10/2020,九+十,港珠澳大橋,入境,76,2,2,80
8/10/2020,九+十,港珠澳大橋,出境,165,14,2,181
8/10/2020,九+十,落馬洲,入境,0,0,0,0
8/10/2020,九+十,落馬洲,出境,0,0,0,0
8/10/2020,九+十,文錦渡,入境,0,0,0,0
8/10/2020,九+十,文錦渡,出境,0,0,0,0
8/10/2020,九+十,沙頭角,入境,0,0,0,0
8/10/2020,九+十,沙頭角,出境,0,0,0,0
8/10/2020,九+十,深圳灣,入境,701,73,2,776
8/10/2020,九+十,深圳灣,出境,931,112,5,1048
8/10/2020,九+十,中國客運碼頭,入境,0,0,0,0
8/10/2020,九+十,中國客運碼頭,出境,0,0,0,0
8/10/2020,九+十,港口管制,入境,0,0,0,0
8/10/2020,九+十,港口管制,出境,0,0,0,0
8/10/2020,九+十,啟德郵輪碼頭,入境,0,0,0,0
8/10/2020,九+十,啟德郵輪碼頭,出境,0,0,0,0
8/10/2020,九+十,港澳客輪碼頭,入境,0,0,0,0
8/10/2020,九+十,港澳客輪碼頭,出境,0,0,0,0
8/10/2020,九+十,屯門客運碼頭,入境,0,0,0,0
8/10/2020,九+十,屯門客運碼頭,出境,0,0,0,0
9/10/2020,九+十,機場,入境,793,5,37,835
9/10/2020,九+十,機場,出境,790,45,26,861
9/10/2020,九+十,高鐵西九龍,入境,0,0,0,0
9/10/2020,九+十,高鐵西九龍,出境,0,0,0,0
9/10/2020,九+十,紅磡,入境,0,0,0,0
9/10/2020,九+十,紅磡,出境,0,0,0,0
9/10/2020,九+十,羅湖,入境,0,0,0,0
9/10/2020,九+十,羅湖,出境,0,0,0,0
9/10/2020,九+十,落馬洲支線,入境,0,0,0,0
9/10/2020,九+十,落馬洲支線,出境,0,0,0,0
9/10/2020,九+十,香園圍,入境,0,0,0,0
9/10/2020,九+十,香園圍,出境,0,0,0,0
9/10/2020,九+十,港珠澳大橋,入境,69,0,7,76
9/10/2020,九+十,港珠澳大橋,出境,142,11,9,162
9/10/2020,九+十,落馬洲,入境,0,0,0,0
9/10/2020,九+十,落馬洲,出境,0,0,0,0
9/10/2020,九+十,文錦渡,入境,0,0,0,0
9/10/2020,九+十,文錦渡,出境,0,0,0,0
9/10/2020,九+十,沙頭角,入境,0,0,0,0
9/10/2020,九+十,沙頭角,出境,0,0,0,0
9/10/2020,九+十,深圳灣,入境,811,99,1,911
9/10/2020,九+十,深圳灣,出境,767,104,11,882
9/10/2020,九+十,中國客運碼頭,入境,0,0,0,0
9/10/2020,九+十,中國客運碼頭,出境,0,0,0,0
9/10/2020,九+十,港口管制,入境,0,0,0,0
9/10/2020,九+十,港口管制,出境,0,0,0,0
9/10/2020,九+十,啟德郵輪碼頭,入境,0,0,0,0
9/10/2020,九+十,啟德郵輪碼頭,出境,0,0,0,0
9/10/2020,九+十,港澳客輪碼頭,入境,0,0,0,0
9/10/2020,九+十,港澳客輪碼頭,出境,0,0,0,0
9/10/2020,九+十,屯門客運碼頭,入境,0,0,0,0
9/10/2020,九+十,屯門客運碼頭,出境,0,0,0,0
10/10/2020,九+十,機場,入境,670,4,14,688
10/10/2020,九+十,機場,出境,1028,30,26,1084
10/10/2020,九+十,高鐵西九龍,入境,0,0,0,0
10/10/2020,九+十,高鐵西九龍,出境,0,0,0,0
10/10/2020,九+十,紅磡,入境,0,0,0,0
10/10/2020,九+十,紅磡,出境,0,0,0,0
10/10/2020,九+十,羅湖,入境,0,0,0,0
10/10/2020,九+十,羅湖,出境,0,0,0,0
10/10/2020,九+十,落馬洲支線,入境,0,0,0,0
10/10/2020,九+十,落馬洲支線,出境,0,0,0,0
10/10/2020,九+十,香園圍,入境,0,0,0,0
10/10/2020,九+十,香園圍,出境,0,0,0,0
10/10/2020,九+十,港珠澳大橋,入境,84,7,4,95
10/10/2020,九+十,港珠澳大橋,出境,110,12,2,124
10/10/2020,九+十,落馬洲,入境,0,0,0,0
10/10/2020,九+十,落馬洲,出境,0,0,0,0
10/10/2020,九+十,文錦渡,入境,0,0,0,0
10/10/2020,九+十,文錦渡,出境,0,0,0,0
10/10/2020,九+十,沙頭角,入境,0,0,0,0
10/10/2020,九+十,沙頭角,出境,0,0,0,0
10/10/2020,九+十,深圳灣,入境,1212,174,2,1388
10/10/2020,九+十,深圳灣,出境,830,125,9,964
10/10/2020,九+十,中國客運碼頭,入境,0,0,0,0
10/10/2020,九+十,中國客運碼頭,出境,0,0,0,0
10/10/2020,九+十,港口管制,入境,0,0,0,0
10/10/2020,九+十,港口管制,出境,0,0,0,0
10/10/2020,九+十,啟德郵輪碼頭,入境,0,0,0,0
10/10/2020,九+十,啟德郵輪碼頭,出境,0,0,0,0
10/10/2020,九+十,港澳客輪碼頭,入境,0,0,0,0
10/10/2020,九+十,港澳客輪碼頭,出境,0,0,0,0
10/10/2020,九+十,屯門客運碼頭,入境,0,0,0,0
10/10/2020,九+十,屯門客運碼頭,出境,0,0,0,0
11/10/2020,九+十,機場,入境,1304,13,68,1385
11/10/2020,九+十,機場,出境,940,48,48,1036
11/10/2020,九+十,高鐵西九龍,入境,0,0,0,0
11/10/2020,九+十,高鐵西九龍,出境,0,0,0,0
11/10/2020,九+十,紅磡,入境,0,0,0,0
11/10/2020,九+十,紅磡,出境,0,0,0,0
11/10/2020,九+十,羅湖,入境,0,0,0,0
11/10/2020,九+十,羅湖,出境,0,0,0,0
11/10/2020,九+十,落馬洲支線,入境,0,0,0,0
11/10/2020,九+十,落馬洲支線,出境,0,0,0,0
11/10/2020,九+十,香園圍,入境,0,0,0,0
11/10/2020,九+十,香園圍,出境,0,0,0,0
11/10/2020,九+十,港珠澳大橋,入境,82,8,3,93
11/10/2020,九+十,港珠澳大橋,出境,70,10,0,80
11/10/2020,九+十,落馬洲,入境,0,0,0,0
11/10/2020,九+十,落馬洲,出境,0,0,0,0
11/10/2020,九+十,文錦渡,入境,0,0,0,0
11/10/2020,九+十,文錦渡,出境,0,0,0,0
11/10/2020,九+十,沙頭角,入境,0,0,0,0
11/10/2020,九+十,沙頭角,出境,0,0,0,0
11/10/2020,九+十,深圳灣,入境,1370,157,3,1530
11/10/2020,九+十,深圳灣,出境,430,106,5,541
11/10/2020,九+十,中國客運碼頭,入境,0,0,0,0
11/10/2020,九+十,中國客運碼頭,出境,0,0,0,0
11/10/2020,九+十,港口管制,入境,0,0,0,0
11/10/2020,九+十,港口管制,出境,0,0,0,0
11/10/2020,九+十,啟德郵輪碼頭,入境,0,0,0,0
11/10/2020,九+十,啟德郵輪碼頭,出境,0,0,0,0
11/10/2020,九+十,港澳客輪碼頭,入境,0,0,0,0
11/10/2020,九+十,港澳客輪碼頭,出境,0,0,0,0
11/10/2020,九+十,屯門客運碼頭,入境,0,0,0,0
11/10/2020,九+十,屯門客運碼頭,出境,0,0,0,0
12/10/2020,九+十,機場,入境,478,10,32,520
12/10/2020,九+十,機場,出境,545,11,40,596
12/10/2020,九+十,高鐵西九龍,入境,0,0,0,0
12/10/2020,九+十,高鐵西九龍,出境,0,0,0,0
12/10/2020,九+十,紅磡,入境,0,0,0,0
12/10/2020,九+十,紅磡,出境,0,0,0,0
12/10/2020,九+十,羅湖,入境,0,0,0,0
12/10/2020,九+十,羅湖,出境,0,0,0,0
12/10/2020,九+十,落馬洲支線,入境,0,0,0,0
12/10/2020,九+十,落馬洲支線,出境,0,0,0,0
12/10/2020,九+十,香園圍,入境,0,0,0,0
12/10/2020,九+十,香園圍,出境,0,0,0,0
12/10/2020,九+十,港珠澳大橋,入境,61,6,2,69
12/10/2020,九+十,港珠澳大橋,出境,103,6,1,110
12/10/2020,九+十,落馬洲,入境,0,0,0,0
12/10/2020,九+十,落馬洲,出境,0,0,0,0
12/10/2020,九+十,文錦渡,入境,0,0,0,0
12/10/2020,九+十,文錦渡,出境,0,0,0,0
12/10/2020,九+十,沙頭角,入境,0,0,0,0
12/10/2020,九+十,沙頭角,出境,0,0,0,0
12/10/2020,九+十,深圳灣,入境,1169,133,5,1307
12/10/2020,九+十,深圳灣,出境,643,73,5,721
12/10/2020,九+十,中國客運碼頭,入境,0,0,0,0
12/10/2020,九+十,中國客運碼頭,出境,0,0,0,0
12/10/2020,九+十,港口管制,入境,0,0,0,0
12/10/2020,九+十,港口管制,出境,0,0,0,0
12/10/2020,九+十,啟德郵輪碼頭,入境,0,0,0,0
12/10/2020,九+十,啟德郵輪碼頭,出境,0,0,0,0
12/10/2020,九+十,港澳客輪碼頭,入境,0,0,0,0
12/10/2020,九+十,港澳客輪碼頭,出境,0,0,0,0
12/10/2020,九+十,屯門客運碼頭,入境,0,0,0,0
12/10/2020,九+十,屯門客運碼頭,出境,0,0,0,0
13/10/2020,九+十,機場,入境,422,2,31,455
13/10/2020,九+十,機場,出境,639,22,27,688
13/10/2020,九+十,高鐵西九龍,入境,0,0,0,0
13/10/2020,九+十,高鐵西九龍,出境,0,0,0,0
13/10/2020,九+十,紅磡,入境,0,0,0,0
13/10/2020,九+十,紅磡,出境,0,0,0,0
13/10/2020,九+十,羅湖,入境,0,0,0,0
13/10/2020,九+十,羅湖,出境,0,0,0,0
13/10/2020,九+十,落馬洲支線,入境,0,0,0,0
13/10/2020,九+十,落馬洲支線,出境,0,0,0,0
13/10/2020,九+十,香園圍,入境,0,0,0,0
13/10/2020,九+十,香園圍,出境,0,0,0,0
13/10/2020,九+十,港珠澳大橋,入境,0,0,0,0
13/10/2020,九+十,港珠澳大橋,出境,0,0,0,0
13/10/2020,九+十,落馬洲,入境,0,0,0,0
13/10/2020,九+十,落馬洲,出境,0,0,0,0
13/10/2020,九+十,文錦渡,入境,0,0,0,0
13/10/2020,九+十,文錦渡,出境,0,0,0,0
13/10/2020,九+十,沙頭角,入境,0,0,0,0
13/10/2020,九+十,沙頭角,出境,0,0,0,0
13/10/2020,九+十,深圳灣,入境,691,88,2,781
13/10/2020,九+十,深圳灣,出境,427,32,4,463
13/10/2020,九+十,中國客運碼頭,入境,0,0,0,0
13/10/2020,九+十,中國客運碼頭,出境,0,0,0,0
13/10/2020,九+十,港口管制,入境,0,0,0,0
13/10/2020,九+十,港口管制,出境,0,0,0,0
13/10/2020,九+十,啟德郵輪碼頭,入境,0,0,0,0
13/10/2020,九+十,啟德郵輪碼頭,出境,0,0,0,0
13/10/2020,九+十,港澳客輪碼頭,入境,0,0,0,0
13/10/2020,九+十,港澳客輪碼頭,出境,0,0,0,0
13/10/2020,九+十,屯門客運碼頭,入境,0,0,0,0
13/10/2020,九+十,屯門客運碼頭,出境,0,0,0,0
14/10/2020,九+十,機場,入境,564,4,30,598
14/10/2020,九+十,機場,出境,656,21,31,708
14/10/2020,九+十,高鐵西九龍,入境,0,0,0,0
14/10/2020,九+十,高鐵西九龍,出境,0,0,0,0
14/10/2020,九+十,紅磡,入境,0,0,0,0
14/10/2020,九+十,紅磡,出境,0,0,0,0
14/10/2020,九+十,羅湖,入境,0,0,0,0
14/10/2020,九+十,羅湖,出境,0,0,0,0
14/10/2020,九+十,落馬洲支線,入境,0,0,0,0
14/10/2020,九+十,落馬洲支線,出境,0,0,0,0
14/10/2020,九+十,香園圍,入境,0,0,0,0
14/10/2020,九+十,香園圍,出境,0,0,0,0
14/10/2020,九+十,港珠澳大橋,入境,104,10,5,119
14/10/2020,九+十,港珠澳大橋,出境,134,8,2,144
14/10/2020,九+十,落馬洲,入境,0,0,0,0
14/10/2020,九+十,落馬洲,出境,0,0,0,0
14/10/2020,九+十,文錦渡,入境,0,0,0,0
14/10/2020,九+十,文錦渡,出境,0,0,0,0
14/10/2020,九+十,沙頭角,入境,0,0,0,0
14/10/2020,九+十,沙頭角,出境,0,0,0,0
14/10/2020,九+十,深圳灣,入境,1046,138,2,1186
14/10/2020,九+十,深圳灣,出境,843,121,16,980
14/10/2020,九+十,中國客運碼頭,入境,0,0,0,0
14/10/2020,九+十,中國客運碼頭,出境,0,0,0,0
14/10/2020,九+十,港口管制,入境,0,0,0,0
14/10/2020,九+十,港口管制,出境,0,0,0,0
14/10/2020,九+十,啟德郵輪碼頭,入境,0,0,0,0
14/10/2020,九+十,啟德郵輪碼頭,出境,0,0,0,0
14/10/2020,九+十,港澳客輪碼頭,入境,0,0,0,0
14/10/2020,九+十,港澳客輪碼頭,出境,0,0,0,0
14/10/2020,九+十,屯門客運碼頭,入境,0,0,0,0
14/10/2020,九+十,屯門客運碼頭,出境,0,0,0,0
15/10/2020,九+十,機場,入境,984,3,53,1040
15/10/2020,九+十,機場,出境,1121,14,64,1199
15/10/2020,九+十,高鐵西九龍,入境,0,0,0,0
15/10/2020,九+十,高鐵西九龍,出境,0,0,0,0
15/10/2020,九+十,紅磡,入境,0,0,0,0
15/10/2020,九+十,紅磡,出境,0,0,0,0
15/10/2020,九+十,羅湖,入境,0,0,0,0
15/10/2020,九+十,羅湖,出境,0,0,0,0
15/10/2020,九+十,落馬洲支線,入境,0,0,0,0
15/10/2020,九+十,落馬洲支線,出境,0,0,0,0
15/10/2020,九+十,香園圍,入境,0,0,0,0
15/10/2020,九+十,香園圍,出境,0,0,0,0
15/10/2020,九+十,港珠澳大橋,入境,111,4,4,119
15/10/2020,九+十,港珠澳大橋,出境,164,7,8,179
15/10/2020,九+十,落馬洲,入境,0,0,0,0
15/10/2020,九+十,落馬洲,出境,0,0,0,0
15/10/2020,九+十,文錦渡,入境,0,0,0,0
15/10/2020,九+十,文錦渡,出境,0,0,0,0
15/10/2020,九+十,沙頭角,入境,0,0,0,0
15/10/2020,九+十,沙頭角,出境,0,0,0,0
15/10/2020,九+十,深圳灣,入境,1204,164,3,1371
15/10/2020,九+十,深圳灣,出境,807,110,5,922
15/10/2020,九+十,中國客運碼頭,入境,0,0,0,0
15/10/2020,九+十,中國客運碼頭,出境,0,0,0,0
15/10/2020,九+十,港口管制,入境,0,0,0,0
15/10/2020,九+十,港口管制,出境,0,0,0,0
15/10/2020,九+十,啟德郵輪碼頭,入境,0,0,0,0
15/10/2020,九+十,啟德郵輪碼頭,出境,0,0,0,0
15/10/2020,九+十,港澳客輪碼頭,入境,0,0,0,0
15/10/2020,九+十,港澳客輪碼頭,出境,0,0,0,0
15/10/2020,九+十,屯門客運碼頭,入境,0,0,0,0
15/10/2020,九+十,屯門客運碼頭,出境,0,0,0,0
16/10/2020,九+十,機場,入境,1153,5,49,1207
16/10/2020,九+十,機場,出境,927,30,42,999
16/10/2020,九+十,高鐵西九龍,入境,0,0,0,0
16/10/2020,九+十,高鐵西九龍,出境,0,0,0,0
16/10/2020,九+十,紅磡,入境,0,0,0,0
16/10/2020,九+十,紅磡,出境,0,0,0,0
16/10/2020,九+十,羅湖,入境,0,0,0,0
16/10/2020,九+十,羅湖,出境,0,0,0,0
16/10/2020,九+十,落馬洲支線,入境,0,0,0,0
16/10/2020,九+十,落馬洲支線,出境,0,0,0,0
16/10/2020,九+十,香園圍,入境,0,0,0,0
16/10/2020,九+十,香園圍,出境,0,0,0,0
16/10/2020,九+十,港珠澳大橋,入境,67,7,3,77
16/10/2020,九+十,港珠澳大橋,出境,177,7,8,192
16/10/2020,九+十,落馬洲,入境,0,0,0,0
16/10/2020,九+十,落馬洲,出境,0,0,0,0
16/10/2020,九+十,文錦渡,入境,0,0,0,0
16/10/2020,九+十,文錦渡,出境,0,0,0,0
16/10/2020,九+十,沙頭角,入境,0,0,0,0
16/10/2020,九+十,沙頭角,出境,0,0,0,0
16/10/2020,九+十,深圳灣,入境,950,138,3,1091
16/10/2020,九+十,深圳灣,出境,1051,159,6,1216
16/10/2020,九+十,中國客運碼頭,入境,0,0,0,0
16/10/2020,九+十,中國客運碼頭,出境,0,0,0,0
16/10/2020,九+十,港口管制,入境,0,0,0,0
16/10/2020,九+十,港口管制,出境,0,0,0,0
16/10/2020,九+十,啟德郵輪碼頭,入境,0,0,0,0
16/10/2020,九+十,啟德郵輪碼頭,出境,0,0,0,0
16/10/2020,九+十,港澳客輪碼頭,入境,0,0,0,0
16/10/2020,九+十,港澳客輪碼頭,出境,0,0,0,0
16/10/2020,九+十,屯門客運碼頭,入境,0,0,0,0
16/10/2020,九+十,屯門客運碼頭,出境,0,0,0,0
17/10/2020,九+十,機場,入境,824,8,9,841
17/10/2020,九+十,機場,出境,996,27,48,1071
17/10/2020,九+十,高鐵西九龍,入境,0,0,0,0
17/10/2020,九+十,高鐵西九龍,出境,0,0,0,0
17/10/2020,九+十,紅磡,入境,0,0,0,0
17/10/2020,九+十,紅磡,出境,0,0,0,0
17/10/2020,九+十,羅湖,入境,0,0,0,0
17/10/2020,九+十,羅湖,出境,0,0,0,0
17/10/2020,九+十,落馬洲支線,入境,0,0,0,0
17/10/2020,九+十,落馬洲支線,出境,0,0,0,0
17/10/2020,九+十,香園圍,入境,0,0,0,0
17/10/2020,九+十,香園圍,出境,0,0,0,0
17/10/2020,九+十,港珠澳大橋,入境,61,6,3,70
17/10/2020,九+十,港珠澳大橋,出境,135,20,1,156
17/10/2020,九+十,落馬洲,入境,0,0,0,0
17/10/2020,九+十,落馬洲,出境,0,0,0,0
17/10/2020,九+十,文錦渡,入境,0,0,0,0
17/10/2020,九+十,文錦渡,出境,0,0,0,0
17/10/2020,九+十,沙頭角,入境,0,0,0,0
17/10/2020,九+十,沙頭角,出境,0,0,0,0
17/10/2020,九+十,深圳灣,入境,985,173,5,1163
17/10/2020,九+十,深圳灣,出境,860,129,4,993
17/10/2020,九+十,中國客運碼頭,入境,0,0,0,0
17/10/2020,九+十,中國客運碼頭,出境,0,0,0,0
17/10/2020,九+十,港口管制,入境,0,0,0,0
17/10/2020,九+十,港口管制,出境,0,0,0,0
17/10/2020,九+十,啟德郵輪碼頭,入境,0,0,0,0
17/10/2020,九+十,啟德郵輪碼頭,出境,0,0,0,0
17/10/2020,九+十,港澳客輪碼頭,入境,0,0,0,0
17/10/2020,九+十,港澳客輪碼頭,出境,0,0,0,0
17/10/2020,九+十,屯門客運碼頭,入境,0,0,0,0
17/10/2020,九+十,屯門客運碼頭,出境,0,0,0,0
18/10/2020,九+十,機場,入境,1057,13,52,1122
18/10/2020,九+十,機場,出境,822,26,38,886
18/10/2020,九+十,高鐵西九龍,入境,0,0,0,0
18/10/2020,九+十,高鐵西九龍,出境,0,0,0,0
18/10/2020,九+十,紅磡,入境,0,0,0,0
18/10/2020,九+十,紅磡,出境,0,0,0,0
18/10/2020,九+十,羅湖,入境,0,0,0,0
18/10/2020,九+十,羅湖,出境,0,0,0,0
18/10/2020,九+十,落馬洲支線,入境,0,0,0,0
18/10/2020,九+十,落馬洲支線,出境,0,0,0,0
18/10/2020,九+十,香園圍,入境,0,0,0,0
18/10/2020,九+十,香園圍,出境,0,0,0,0
18/10/2020,九+十,港珠澳大橋,入境,70,8,5,83
18/10/2020,九+十,港珠澳大橋,出境,82,5,6,93
18/10/2020,九+十,落馬洲,入境,0,0,0,0
18/10/2020,九+十,落馬洲,出境,0,0,0,0
18/10/2020,九+十,文錦渡,入境,0,0,0,0
18/10/2020,九+十,文錦渡,出境,0,0,0,0
18/10/2020,九+十,沙頭角,入境,0,0,0,0
18/10/2020,九+十,沙頭角,出境,0,0,0,0
18/10/2020,九+十,深圳灣,入境,1363,193,1,1557
18/10/2020,九+十,深圳灣,出境,479,84,4,567
18/10/2020,九+十,中國客運碼頭,入境,0,0,0,0
18/10/2020,九+十,中國客運碼頭,出境,0,0,0,0
18/10/2020,九+十,港口管制,入境,0,0,0,0
18/10/2020,九+十,港口管制,出境,0,0,0,0
18/10/2020,九+十,啟德郵輪碼頭,入境,0,0,0,0
18/10/2020,九+十,啟德郵輪碼頭,出境,0,0,0,0
18/10/2020,九+十,港澳客輪碼頭,入境,0,0,0,0
18/10/2020,九+十,港澳客輪碼頭,出境,0,0,0,0
18/10/2020,九+十,屯門客運碼頭,入境,0,0,0,0
18/10/2020,九+十,屯門客運碼頭,出境,0,0,0,0
19/10/2020,九+十,機場,入境,462,2,31,495
19/10/2020,九+十,機場,出境,613,8,28,649
19/10/2020,九+十,高鐵西九龍,入境,0,0,0,0
19/10/2020,九+十,高鐵西九龍,出境,0,0,0,0
19/10/2020,九+十,紅磡,入境,0,0,0,0
19/10/2020,九+十,紅磡,出境,0,0,0,0
19/10/2020,九+十,羅湖,入境,0,0,0,0
19/10/2020,九+十,羅湖,出境,0,0,0,0
19/10/2020,九+十,落馬洲支線,入境,0,0,0,0
19/10/2020,九+十,落馬洲支線,出境,0,0,0,0
19/10/2020,九+十,香園圍,入境,0,0,0,0
19/10/2020,九+十,香園圍,出境,0,0,0,0
19/10/2020,九+十,港珠澳大橋,入境,84,3,6,93
19/10/2020,九+十,港珠澳大橋,出境,115,4,2,121
19/10/2020,九+十,落馬洲,入境,0,0,0,0
19/10/2020,九+十,落馬洲,出境,0,0,0,0
19/10/2020,九+十,文錦渡,入境,0,0,0,0
19/10/2020,九+十,文錦渡,出境,0,0,0,0
19/10/2020,九+十,沙頭角,入境,0,0,0,0
19/10/2020,九+十,沙頭角,出境,0,0,0,0
19/10/2020,九+十,深圳灣,入境,1048,121,2,1171
19/10/2020,九+十,深圳灣,出境,491,50,3,544
19/10/2020,九+十,中國客運碼頭,入境,0,0,0,0
19/10/2020,九+十,中國客運碼頭,出境,0,0,0,0
19/10/2020,九+十,港口管制,入境,0,0,0,0
19/10/2020,九+十,港口管制,出境,0,0,0,0
19/10/2020,九+十,啟德郵輪碼頭,入境,0,0,0,0
19/10/2020,九+十,啟德郵輪碼頭,出境,0,0,0,0
19/10/2020,九+十,港澳客輪碼頭,入境,0,0,0,0
19/10/2020,九+十,港澳客輪碼頭,出境,0,0,0,0
19/10/2020,九+十,屯門客運碼頭,入境,0,0,0,0
19/10/2020,九+十,屯門客運碼頭,出境,0,0,0,0
20/10/2020,九+十,機場,入境,512,5,16,533
20/10/2020,九+十,機場,出境,842,10,93,945
20/10/2020,九+十,高鐵西九龍,入境,0,0,0,0
20/10/2020,九+十,高鐵西九龍,出境,0,0,0,0
20/10/2020,九+十,紅磡,入境,0,0,0,0
20/10/2020,九+十,紅磡,出境,0,0,0,0
20/10/2020,九+十,羅湖,入境,0,0,0,0
20/10/2020,九+十,羅湖,出境,0,0,0,0
20/10/2020,九+十,落馬洲支線,入境,0,0,0,0
20/10/2020,九+十,落馬洲支線,出境,0,0,0,0
20/10/2020,九+十,香園圍,入境,0,0,0,0
20/10/2020,九+十,香園圍,出境,0,0,0,0
20/10/2020,九+十,港珠澳大橋,入境,59,3,70,132
20/10/2020,九+十,港珠澳大橋,出境,120,5,1,126
20/10/2020,九+十,落馬洲,入境,0,0,0,0
20/10/2020,九+十,落馬洲,出境,0,0,0,0
20/10/2020,九+十,文錦渡,入境,0,0,0,0
20/10/2020,九+十,文錦渡,出境,0,0,0,0
20/10/2020,九+十,沙頭角,入境,0,0,0,0
20/10/2020,九+十,沙頭角,出境,0,0,0,0
20/10/2020,九+十,深圳灣,入境,934,148,7,1089
20/10/2020,九+十,深圳灣,出境,731,83,4,818
20/10/2020,九+十,中國客運碼頭,入境,0,0,0,0
20/10/2020,九+十,中國客運碼頭,出境,0,0,0,0
20/10/2020,九+十,港口管制,入境,0,0,0,0
20/10/2020,九+十,港口管制,出境,0,0,0,0
20/10/2020,九+十,啟德郵輪碼頭,入境,0,0,0,0
20/10/2020,九+十,啟德郵輪碼頭,出境,0,0,0,0
20/10/2020,九+十,港澳客輪碼頭,入境,0,0,0,0
20/10/2020,九+十,港澳客輪碼頭,出境,0,0,0,0
20/10/2020,九+十,屯門客運碼頭,入境,0,0,0,0
20/10/2020,九+十,屯門客運碼頭,出境,0,0,0,0
21/10/2020,九+十,機場,入境,770,2,31,803
21/10/2020,九+十,機場,出境,715,10,78,803
21/10/2020,九+十,高鐵西九龍,入境,0,0,0,0
21/10/2020,九+十,高鐵西九龍,出境,0,0,0,0
21/10/2020,九+十,紅磡,入境,0,0,0,0
21/10/2020,九+十,紅磡,出境,0,0,0,0
21/10/2020,九+十,羅湖,入境,0,0,0,0
21/10/2020,九+十,羅湖,出境,0,0,0,0
21/10/2020,九+十,落馬洲支線,入境,0,0,0,0
21/10/2020,九+十,落馬洲支線,出境,0,0,0,0
21/10/2020,九+十,香園圍,入境,0,0,0,0
21/10/2020,九+十,香園圍,出境,0,0,0,0
21/10/2020,九+十,港珠澳大橋,入境,49,10,7,66
21/10/2020,九+十,港珠澳大橋,出境,172,11,2,185
21/10/2020,九+十,落馬洲,入境,0,0,0,0
21/10/2020,九+十,落馬洲,出境,0,0,0,0
21/10/2020,九+十,文錦渡,入境,0,0,0,0
21/10/2020,九+十,文錦渡,出境,0,0,0,0
21/10/2020,九+十,沙頭角,入境,0,0,0,0
21/10/2020,九+十,沙頭角,出境,0,0,0,0
21/10/2020,九+十,深圳灣,入境,845,148,6,999
21/10/2020,九+十,深圳灣,出境,938,123,9,1070
21/10/2020,九+十,中國客運碼頭,入境,0,0,0,0
21/10/2020,九+十,中國客運碼頭,出境,0,0,0,0
21/10/2020,九+十,港口管制,入境,0,0,0,0
21/10/2020,九+十,港口管制,出境,0,0,0,0
21/10/2020,九+十,啟德郵輪碼頭,入境,0,0,0,0
21/10/2020,九+十,啟德郵輪碼頭,出境,0,0,0,0
21/10/2020,九+十,港澳客輪碼頭,入境,0,0,0,0
21/10/2020,九+十,港澳客輪碼頭,出境,0,0,0,0
21/10/2020,九+十,屯門客運碼頭,入境,0,0,0,0
21/10/2020,九+十,屯門客運碼頭,出境,0,0,0,0
22/10/2020,九+十,機場,入境,517,2,34,553
22/10/2020,九+十,機場,出境,661,7,43,711
22/10/2020,九+十,高鐵西九龍,入境,0,0,0,0
22/10/2020,九+十,高鐵西九龍,出境,0,0,0,0
22/10/2020,九+十,紅磡,入境,0,0,0,0
22/10/2020,九+十,紅磡,出境,0,0,0,0
22/10/2020,九+十,羅湖,入境,0,0,0,0
22/10/2020,九+十,羅湖,出境,0,0,0,0
22/10/2020,九+十,落馬洲支線,入境,0,0,0,0
22/10/2020,九+十,落馬洲支線,出境,0,0,0,0
22/10/2020,九+十,香園圍,入境,0,0,0,0
22/10/2020,九+十,香園圍,出境,0,0,0,0
22/10/2020,九+十,港珠澳大橋,入境,56,6,7,69
22/10/2020,九+十,港珠澳大橋,出境,130,7,2,139
22/10/2020,九+十,落馬洲,入境,0,0,0,0
22/10/2020,九+十,落馬洲,出境,0,0,0,0
22/10/2020,九+十,文錦渡,入境,0,0,0,0
22/10/2020,九+十,文錦渡,出境,0,0,0,0
22/10/2020,九+十,沙頭角,入境,0,0,0,0
22/10/2020,九+十,沙頭角,出境,0,0,0,0
22/10/2020,九+十,深圳灣,入境,810,156,2,968
22/10/2020,九+十,深圳灣,出境,725,102,4,831
22/10/2020,九+十,中國客運碼頭,入境,0,0,0,0
22/10/2020,九+十,中國客運碼頭,出境,0,0,0,0
22/10/2020,九+十,港口管制,入境,0,0,0,0
22/10/2020,九+十,港口管制,出境,0,0,0,0
22/10/2020,九+十,啟德郵輪碼頭,入境,0,0,0,0
22/10/2020,九+十,啟德郵輪碼頭,出境,0,0,0,0
22/10/2020,九+十,港澳客輪碼頭,入境,0,0,0,0
22/10/2020,九+十,港澳客輪碼頭,出境,0,0,0,0
22/10/2020,九+十,屯門客運碼頭,入境,0,0,0,0
22/10/2020,九+十,屯門客運碼頭,出境,0,0,0,0
23/10/2020,九+十,機場,入境,796,2,42,840
23/10/2020,九+十,機場,出境,953,25,58,1036
23/10/2020,九+十,高鐵西九龍,入境,0,0,0,0
23/10/2020,九+十,高鐵西九龍,出境,0,0,0,0
23/10/2020,九+十,紅磡,入境,0,0,0,0
23/10/2020,九+十,紅磡,出境,0,0,0,0
23/10/2020,九+十,羅湖,入境,0,0,0,0
23/10/2020,九+十,羅湖,出境,0,0,0,0
23/10/2020,九+十,落馬洲支線,入境,0,0,0,0
23/10/2020,九+十,落馬洲支線,出境,0,0,0,0
23/10/2020,九+十,香園圍,入境,0,0,0,0
23/10/2020,九+十,香園圍,出境,0,0,0,0
23/10/2020,九+十,港珠澳大橋,入境,81,2,5,88
23/10/2020,九+十,港珠澳大橋,出境,122,4,4,130
23/10/2020,九+十,落馬洲,入境,0,0,0,0
23/10/2020,九+十,落馬洲,出境,0,0,0,0
23/10/2020,九+十,文錦渡,入境,0,0,0,0
23/10/2020,九+十,文錦渡,出境,0,0,0,0
23/10/2020,九+十,沙頭角,入境,0,0,0,0
23/10/2020,九+十,沙頭角,出境,0,0,0,0
23/10/2020,九+十,深圳灣,入境,747,156,3,906
23/10/2020,九+十,深圳灣,出境,674,80,3,757
23/10/2020,九+十,中國客運碼頭,入境,0,0,0,0
23/10/2020,九+十,中國客運碼頭,出境,0,0,0,0
23/10/2020,九+十,港口管制,入境,0,0,0,0
23/10/2020,九+十,港口管制,出境,0,0,0,0
23/10/2020,九+十,啟德郵輪碼頭,入境,0,0,0,0
23/10/2020,九+十,啟德郵輪碼頭,出境,0,0,0,0
23/10/2020,九+十,港澳客輪碼頭,入境,0,0,0,0
23/10/2020,九+十,港澳客輪碼頭,出境,0,0,0,0
23/10/2020,九+十,屯門客運碼頭,入境,0,0,0,0
23/10/2020,九+十,屯門客運碼頭,出境,0,0,0,0
24/10/2020,九+十,機場,入境,986,7,27,1020
24/10/2020,九+十,機場,出境,904,9,26,939
24/10/2020,九+十,高鐵西九龍,入境,0,0,0,0
24/10/2020,九+十,高鐵西九龍,出境,0,0,0,0
24/10/2020,九+十,紅磡,入境,0,0,0,0
24/10/2020,九+十,紅磡,出境,0,0,0,0
24/10/2020,九+十,羅湖,入境,0,0,0,0
24/10/2020,九+十,羅湖,出境,0,0,0,0
24/10/2020,九+十,落馬洲支線,入境,0,0,0,0
24/10/2020,九+十,落馬洲支線,出境,0,0,0,0
24/10/2020,九+十,香園圍,入境,0,0,0,0
24/10/2020,九+十,香園圍,出境,0,0,0,0
24/10/2020,九+十,港珠澳大橋,入境,44,6,3,53
24/10/2020,九+十,港珠澳大橋,出境,93,10,6,109
24/10/2020,九+十,落馬洲,入境,0,0,0,0
24/10/2020,九+十,落馬洲,出境,0,0,0,0
24/10/2020,九+十,文錦渡,入境,0,0,0,0
24/10/2020,九+十,文錦渡,出境,0,0,0,0
24/10/2020,九+十,沙頭角,入境,0,0,0,0
24/10/2020,九+十,沙頭角,出境,0,0,0,0
24/10/2020,九+十,深圳灣,入境,714,134,5,853
24/10/2020,九+十,深圳灣,出境,602,75,4,681
24/10/2020,九+十,中國客運碼頭,入境,0,0,0,0
24/10/2020,九+十,中國客運碼頭,出境,0,0,0,0
24/10/2020,九+十,港口管制,入境,0,0,0,0
24/10/2020,九+十,港口管制,出境,0,0,0,0
24/10/2020,九+十,啟德郵輪碼頭,入境,0,0,0,0
24/10/2020,九+十,啟德郵輪碼頭,出境,0,0,0,0
24/10/2020,九+十,港澳客輪碼頭,入境,0,0,0,0
24/10/2020,九+十,港澳客輪碼頭,出境,0,0,0,0
24/10/2020,九+十,屯門客運碼頭,入境,0,0,0,0
24/10/2020,九+十,屯門客運碼頭,出境,0,0,0,0
25/10/2020,九+十,機場,入境,911,14,38,963
25/10/2020,九+十,機場,出境,953,31,48,1032
25/10/2020,九+十,高鐵西九龍,入境,0,0,0,0
25/10/2020,九+十,高鐵西九龍,出境,0,0,0,0
25/10/2020,九+十,紅磡,入境,0,0,0,0
25/10/2020,九+十,紅磡,出境,0,0,0,0
25/10/2020,九+十,羅湖,入境,0,0,0,0
25/10/2020,九+十,羅湖,出境,0,0,0,0
25/10/2020,九+十,落馬洲支線,入境,0,0,0,0
25/10/2020,九+十,落馬洲支線,出境,0,0,0,0
25/10/2020,九+十,香園圍,入境,0,0,0,0
25/10/2020,九+十,香園圍,出境,0,0,0,0
25/10/2020,九+十,港珠澳大橋,入境,56,3,9,68
25/10/2020,九+十,港珠澳大橋,出境,78,3,6,87
25/10/2020,九+十,落馬洲,入境,0,0,0,0
25/10/2020,九+十,落馬洲,出境,0,0,0,0
25/10/2020,九+十,文錦渡,入境,0,0,0,0
25/10/2020,九+十,文錦渡,出境,0,0,0,0
25/10/2020,九+十,沙頭角,入境,0,0,0,0
25/10/2020,九+十,沙頭角,出境,0,0,0,0
25/10/2020,九+十,深圳灣,入境,942,228,6,1176
25/10/2020,九+十,深圳灣,出境,423,46,3,472
25/10/2020,九+十,中國客運碼頭,入境,0,0,0,0
25/10/2020,九+十,中國客運碼頭,出境,0,0,0,0
25/10/2020,九+十,港口管制,入境,0,0,0,0
25/10/2020,九+十,港口管制,出境,0,0,0,0
25/10/2020,九+十,啟德郵輪碼頭,入境,0,0,0,0
25/10/2020,九+十,啟德郵輪碼頭,出境,0,0,0,0
25/10/2020,九+十,港澳客輪碼頭,入境,0,0,0,0
25/10/2020,九+十,港澳客輪碼頭,出境,0,0,0,0
25/10/2020,九+十,屯門客運碼頭,入境,0,0,0,0
25/10/2020,九+十,屯門客運碼頭,出境,0,0,0,0
26/10/2020,十一,機場,入境,575,3,21,599
26/10/2020,十一,機場,出境,542,7,26,575
26/10/2020,十一,高鐵西九龍,入境,0,0,0,0
26/10/2020,十一,高鐵西九龍,出境,0,0,0,0
26/10/2020,十一,紅磡,入境,0,0,0,0
26/10/2020,十一,紅磡,出境,0,0,0,0
26/10/2020,十一,羅湖,入境,0,0,0,0
26/10/2020,十一,羅湖,出境,0,0,0,0
26/10/2020,十一,落馬洲支線,入境,0,0,0,0
26/10/2020,十一,落馬洲支線,出境,0,0,0,0
26/10/2020,十一,香園圍,入境,0,0,0,0
26/10/2020,十一,香園圍,出境,0,0,0,0
26/10/2020,十一,港珠澳大橋,入境,48,3,8,59
26/10/2020,十一,港珠澳大橋,出境,41,7,1,49
26/10/2020,十一,落馬洲,入境,0,0,0,0
26/10/2020,十一,落馬洲,出境,0,0,0,0
26/10/2020,十一,文錦渡,入境,0,0,0,0
26/10/2020,十一,文錦渡,出境,0,0,0,0
26/10/2020,十一,沙頭角,入境,0,0,0,0
26/10/2020,十一,沙頭角,出境,0,0,0,0
26/10/2020,十一,深圳灣,入境,966,137,1,1104
26/10/2020,十一,深圳灣,出境,279,21,5,305
26/10/2020,十一,中國客運碼頭,入境,0,0,0,0
26/10/2020,十一,中國客運碼頭,出境,0,0,0,0
26/10/2020,十一,港口管制,入境,0,0,0,0
26/10/2020,十一,港口管制,出境,0,0,0,0
26/10/2020,十一,啟德郵輪碼頭,入境,0,0,0,0
26/10/2020,十一,啟德郵輪碼頭,出境,0,0,0,0
26/10/2020,十一,港澳客輪碼頭,入境,0,0,0,0
26/10/2020,十一,港澳客輪碼頭,出境,0,0,0,0
26/10/2020,十一,屯門客運碼頭,入境,0,0,0,0
26/10/2020,十一,屯門客運碼頭,出境,0,0,0,0
27/10/2020,十一,機場,入境,534,2,17,553
27/10/2020,十一,機場,出境,546,4,28,578
27/10/2020,十一,高鐵西九龍,入境,0,0,0,0
27/10/2020,十一,高鐵西九龍,出境,0,0,0,0
27/10/2020,十一,紅磡,入境,0,0,0,0
27/10/2020,十一,紅磡,出境,0,0,0,0
27/10/2020,十一,羅湖,入境,0,0,0,0
27/10/2020,十一,羅湖,出境,0,0,0,0
27/10/2020,十一,落馬洲支線,入境,0,0,0,0
27/10/2020,十一,落馬洲支線,出境,0,0,0,0
27/10/2020,十一,香園圍,入境,0,0,0,0
27/10/2020,十一,香園圍,出境,0,0,0,0
27/10/2020,十一,港珠澳大橋,入境,62,2,3,67
27/10/2020,十一,港珠澳大橋,出境,55,1,1,57
27/10/2020,十一,落馬洲,入境,0,0,0,0
27/10/2020,十一,落馬洲,出境,0,0,0,0
27/10/2020,十一,文錦渡,入境,0,0,0,0
27/10/2020,十一,文錦渡,出境,0,0,0,0
27/10/2020,十一,沙頭角,入境,0,0,0,0
27/10/2020,十一,沙頭角,出境,0,0,0,0
27/10/2020,十一,深圳灣,入境,868,128,3,999
27/10/2020,十一,深圳灣,出境,390,30,1,421
27/10/2020,十一,中國客運碼頭,入境,0,0,0,0
27/10/2020,十一,中國客運碼頭,出境,0,0,0,0
27/10/2020,十一,港口管制,入境,0,0,0,0
27/10/2020,十一,港口管制,出境,0,0,0,0
27/10/2020,十一,啟德郵輪碼頭,入境,0,0,0,0
27/10/2020,十一,啟德郵輪碼頭,出境,0,0,0,0
27/10/2020,十一,港澳客輪碼頭,入境,0,0,0,0
27/10/2020,十一,港澳客輪碼頭,出境,0,0,0,0
27/10/2020,十一,屯門客運碼頭,入境,0,0,0,0
27/10/2020,十一,屯門客運碼頭,出境,0,0,0,0
28/10/2020,十一,機場,入境,352,2,23,377
28/10/2020,十一,機場,出境,479,11,28,518
28/10/2020,十一,高鐵西九龍,入境,0,0,0,0
28/10/2020,十一,高鐵西九龍,出境,0,0,0,0
28/10/2020,十一,紅磡,入境,0,0,0,0
28/10/2020,十一,紅磡,出境,0,0,0,0
28/10/2020,十一,羅湖,入境,0,0,0,0
28/10/2020,十一,羅湖,出境,0,0,0,0
28/10/2020,十一,落馬洲支線,入境,0,0,0,0
28/10/2020,十一,落馬洲支線,出境,0,0,0,0
28/10/2020,十一,香園圍,入境,0,0,0,0
28/10/2020,十一,香園圍,出境,0,0,0,0
28/10/2020,十一,港珠澳大橋,入境,64,2,6,72
28/10/2020,十一,港珠澳大橋,出境,141,2,4,147
28/10/2020,十一,落馬洲,入境,0,0,0,0
28/10/2020,十一,落馬洲,出境,0,0,0,0
28/10/2020,十一,文錦渡,入境,0,0,0,0
28/10/2020,十一,文錦渡,出境,0,0,0,0
28/10/2020,十一,沙頭角,入境,0,0,0,0
28/10/2020,十一,沙頭角,出境,0,0,0,0
28/10/2020,十一,深圳灣,入境,557,108,4,669
28/10/2020,十一,深圳灣,出境,737,79,4,820
28/10/2020,十一,中國客運碼頭,入境,0,0,0,0
28/10/2020,十一,中國客運碼頭,出境,0,0,0,0
28/10/2020,十一,港口管制,入境,0,0,0,0
28/10/2020,十一,港口管制,出境,0,0,0,0
28/10/2020,十一,啟德郵輪碼頭,入境,0,0,0,0
28/10/2020,十一,啟德郵輪碼頭,出境,0,0,0,0
28/10/2020,十一,港澳客輪碼頭,入境,0,0,0,0
28/10/2020,十一,港澳客輪碼頭,出境,0,0,0,0
28/10/2020,十一,屯門客運碼頭,入境,0,0,0,0
28/10/2020,十一,屯門客運碼頭,出境,0,0,0,0
29/10/2020,十一,機場,入境,534,6,28,568
29/10/2020,十一,機場,出境,731,8,45,784
29/10/2020,十一,高鐵西九龍,入境,0,0,0,0
29/10/2020,十一,高鐵西九龍,出境,0,0,0,0
29/10/2020,十一,紅磡,入境,0,0,0,0
29/10/2020,十一,紅磡,出境,0,0,0,0
29/10/2020,十一,羅湖,入境,0,0,0,0
29/10/2020,十一,羅湖,出境,0,0,0,0
29/10/2020,十一,落馬洲支線,入境,0,0,0,0
29/10/2020,十一,落馬洲支線,出境,0,0,0,0
29/10/2020,十一,香園圍,入境,0,0,0,0
29/10/2020,十一,香園圍,出境,0,0,0,0
29/10/2020,十一,港珠澳大橋,入境,62,3,5,70
29/10/2020,十一,港珠澳大橋,出境,144,11,4,159
29/10/2020,十一,落馬洲,入境,0,0,0,0
29/10/2020,十一,落馬洲,出境,0,0,0,0
29/10/2020,十一,文錦渡,入境,0,0,0,0
29/10/2020,十一,文錦渡,出境,0,0,0,0
29/10/2020,十一,沙頭角,入境,0,0,0,0
29/10/2020,十一,沙頭角,出境,0,0,0,0
29/10/2020,十一,深圳灣,入境,478,81,1,560
29/10/2020,十一,深圳灣,出境,814,90,2,906
29/10/2020,十一,中國客運碼頭,入境,0,0,0,0
29/10/2020,十一,中國客運碼頭,出境,0,0,0,0
29/10/2020,十一,港口管制,入境,0,0,0,0
29/10/2020,十一,港口管制,出境,0,0,0,0
29/10/2020,十一,啟德郵輪碼頭,入境,0,0,0,0
29/10/2020,十一,啟德郵輪碼頭,出境,0,0,0,0
29/10/2020,十一,港澳客輪碼頭,入境,0,0,0,0
29/10/2020,十一,港澳客輪碼頭,出境,0,0,0,0
29/10/2020,十一,屯門客運碼頭,入境,0,0,0,0
29/10/2020,十一,屯門客運碼頭,出境,0,0,0,0
30/10/2020,十一,機場,入境,890,4,37,931
30/10/2020,十一,機場,出境,986,26,57,1069
30/10/2020,十一,高鐵西九龍,入境,0,0,0,0
30/10/2020,十一,高鐵西九龍,出境,0,0,0,0
30/10/2020,十一,紅磡,入境,0,0,0,0
30/10/2020,十一,紅磡,出境,0,0,0,0
30/10/2020,十一,羅湖,入境,0,0,0,0
30/10/2020,十一,羅湖,出境,0,0,0,0
30/10/2020,十一,落馬洲支線,入境,0,0,0,0
30/10/2020,十一,落馬洲支線,出境,0,0,0,0
30/10/2020,十一,香園圍,入境,0,0,0,0
30/10/2020,十一,香園圍,出境,0,0,0,0
30/10/2020,十一,港珠澳大橋,入境,55,3,6,64
30/10/2020,十一,港珠澳大橋,出境,137,9,6,152
30/10/2020,十一,落馬洲,入境,0,0,0,0
30/10/2020,十一,落馬洲,出境,0,0,0,0
30/10/2020,十一,文錦渡,入境,0,0,0,0
30/10/2020,十一,文錦渡,出境,0,0,0,0
30/10/2020,十一,沙頭角,入境,0,0,0,0
30/10/2020,十一,沙頭角,出境,0,0,0,0
30/10/2020,十一,深圳灣,入境,544,102,2,648
30/10/2020,十一,深圳灣,出境,698,72,6,776
30/10/2020,十一,中國客運碼頭,入境,0,0,0,0
30/10/2020,十一,中國客運碼頭,出境,0,0,0,0
30/10/2020,十一,港口管制,入境,0,0,0,0
30/10/2020,十一,港口管制,出境,0,0,0,0
30/10/2020,十一,啟德郵輪碼頭,入境,0,0,0,0
30/10/2020,十一,啟德郵輪碼頭,出境,0,0,0,0
30/10/2020,十一,港澳客輪碼頭,入境,0,0,0,0
30/10/2020,十一,港澳客輪碼頭,出境,0,0,0,0
30/10/2020,十一,屯門客運碼頭,入境,0,0,0,0
30/10/2020,十一,屯門客運碼頭,出境,0,0,0,0
31/10/2020,十一,機場,入境,776,5,19,800
31/10/2020,十一,機場,出境,1262,19,36,1317
31/10/2020,十一,高鐵西九龍,入境,0,0,0,0
31/10/2020,十一,高鐵西九龍,出境,0,0,0,0
31/10/2020,十一,紅磡,入境,0,0,0,0
31/10/2020,十一,紅磡,出境,0,0,0,0
31/10/2020,十一,羅湖,入境,0,0,0,0
31/10/2020,十一,羅湖,出境,0,0,0,0
31/10/2020,十一,落馬洲支線,入境,0,0,0,0
31/10/2020,十一,落馬洲支線,出境,0,0,0,0
31/10/2020,十一,香園圍,入境,0,0,0,0
31/10/2020,十一,香園圍,出境,0,0,0,0
31/10/2020,十一,港珠澳大橋,入境,48,3,4,55
31/10/2020,十一,港珠澳大橋,出境,123,8,0,131
31/10/2020,十一,落馬洲,入境,0,0,0,0
31/10/2020,十一,落馬洲,出境,0,0,0,0
31/10/2020,十一,文錦渡,入境,0,0,0,0
31/10/2020,十一,文錦渡,出境,0,0,0,0
31/10/2020,十一,沙頭角,入境,0,0,0,0
31/10/2020,十一,沙頭角,出境,0,0,0,0
31/10/2020,十一,深圳灣,入境,516,131,4,651
31/10/2020,十一,深圳灣,出境,614,72,11,697
31/10/2020,十一,中國客運碼頭,入境,0,0,0,0
31/10/2020,十一,中國客運碼頭,出境,0,0,0,0
31/10/2020,十一,港口管制,入境,0,0,0,0
31/10/2020,十一,港口管制,出境,0,0,0,0
31/10/2020,十一,啟德郵輪碼頭,入境,0,0,0,0
31/10/2020,十一,啟德郵輪碼頭,出境,0,0,0,0
31/10/2020,十一,港澳客輪碼頭,入境,0,0,0,0
31/10/2020,十一,港澳客輪碼頭,出境,0,0,0,0
31/10/2020,十一,屯門客運碼頭,入境,0,0,0,0
31/10/2020,十一,屯門客運碼頭,出境,0,0,0,0
1/11/2020,十一,機場,入境,1021,1,47,1069
1/11/2020,十一,機場,出境,935,8,39,982
1/11/2020,十一,高鐵西九龍,入境,0,0,0,0
1/11/2020,十一,高鐵西九龍,出境,0,0,0,0
1/11/2020,十一,紅磡,入境,0,0,0,0
1/11/2020,十一,紅磡,出境,0,0,0,0
1/11/2020,十一,羅湖,入境,0,0,0,0
1/11/2020,十一,羅湖,出境,0,0,0,0
1/11/2020,十一,落馬洲支線,入境,0,0,0,0
1/11/2020,十一,落馬洲支線,出境,0,0,0,0
1/11/2020,十一,香園圍,入境,0,0,0,0
1/11/2020,十一,香園圍,出境,0,0,0,0
1/11/2020,十一,港珠澳大橋,入境,61,8,4,73
1/11/2020,十一,港珠澳大橋,出境,122,5,4,131
1/11/2020,十一,落馬洲,入境,0,0,0,0
1/11/2020,十一,落馬洲,出境,0,0,0,0
1/11/2020,十一,文錦渡,入境,0,0,0,0
1/11/2020,十一,文錦渡,出境,0,0,0,0
1/11/2020,十一,沙頭角,入境,0,0,0,0
1/11/2020,十一,沙頭角,出境,0,0,0,0
1/11/2020,十一,深圳灣,入境,1075,173,8,1256
1/11/2020,十一,深圳灣,出境,444,69,3,516
1/11/2020,十一,中國客運碼頭,入境,0,0,0,0
1/11/2020,十一,中國客運碼頭,出境,0,0,0,0
1/11/2020,十一,港口管制,入境,0,0,0,0
1/11/2020,十一,港口管制,出境,0,0,0,0
1/11/2020,十一,啟德郵輪碼頭,入境,0,0,0,0
1/11/2020,十一,啟德郵輪碼頭,出境,0,0,0,0
1/11/2020,十一,港澳客輪碼頭,入境,0,0,0,0
1/11/2020,十一,港澳客輪碼頭,出境,0,0,0,0
1/11/2020,十一,屯門客運碼頭,入境,0,0,0,0
1/11/2020,十一,屯門客運碼頭,出境,0,0,0,0
2/11/2020,十一,機場,入境,503,0,25,528
2/11/2020,十一,機場,出境,472,9,17,498
2/11/2020,十一,高鐵西九龍,入境,0,0,0,0
2/11/2020,十一,高鐵西九龍,出境,0,0,0,0
2/11/2020,十一,紅磡,入境,0,0,0,0
2/11/2020,十一,紅磡,出境,0,0,0,0
2/11/2020,十一,羅湖,入境,0,0,0,0
2/11/2020,十一,羅湖,出境,0,0,0,0
2/11/2020,十一,落馬洲支線,入境,0,0,0,0
2/11/2020,十一,落馬洲支線,出境,0,0,0,0
2/11/2020,十一,香園圍,入境,0,0,0,0
2/11/2020,十一,香園圍,出境,0,0,0,0
2/11/2020,十一,港珠澳大橋,入境,70,6,0,76
2/11/2020,十一,港珠澳大橋,出境,81,3,0,84
2/11/2020,十一,落馬洲,入境,0,0,0,0
2/11/2020,十一,落馬洲,出境,0,0,0,0
2/11/2020,十一,文錦渡,入境,0,0,0,0
2/11/2020,十一,文錦渡,出境,0,0,0,0
2/11/2020,十一,沙頭角,入境,0,0,0,0
2/11/2020,十一,沙頭角,出境,0,0,0,0
2/11/2020,十一,深圳灣,入境,838,122,1,961
2/11/2020,十一,深圳灣,出境,357,44,2,403
2/11/2020,十一,中國客運碼頭,入境,0,0,0,0
2/11/2020,十一,中國客運碼頭,出境,0,0,0,0
2/11/2020,十一,港口管制,入境,0,0,0,0
2/11/2020,十一,港口管制,出境,0,0,0,0
2/11/2020,十一,啟德郵輪碼頭,入境,0,0,0,0
2/11/2020,十一,啟德郵輪碼頭,出境,0,0,0,0
2/11/2020,十一,港澳客輪碼頭,入境,0,0,0,0
2/11/2020,十一,港澳客輪碼頭,出境,0,0,0,0
2/11/2020,十一,屯門客運碼頭,入境,0,0,0,0
2/11/2020,十一,屯門客運碼頭,出境,0,0,0,0
3/11/2020,十一,機場,入境,717,14,32,763
3/11/2020,十一,機場,出境,1139,20,96,1255
3/11/2020,十一,高鐵西九龍,入境,0,0,0,0
3/11/2020,十一,高鐵西九龍,出境,0,0,0,0
3/11/2020,十一,紅磡,入境,0,0,0,0
3/11/2020,十一,紅磡,出境,0,0,0,0
3/11/2020,十一,羅湖,入境,0,0,0,0
3/11/2020,十一,羅湖,出境,0,0,0,0
3/11/2020,十一,落馬洲支線,入境,0,0,0,0
3/11/2020,十一,落馬洲支線,出境,0,0,0,0
3/11/2020,十一,香園圍,入境,0,0,0,0
3/11/2020,十一,香園圍,出境,0,0,0,0
3/11/2020,十一,港珠澳大橋,入境,59,4,6,69
3/11/2020,十一,港珠澳大橋,出境,162,8,3,173
3/11/2020,十一,落馬洲,入境,0,0,0,0
3/11/2020,十一,落馬洲,出境,0,0,0,0
3/11/2020,十一,文錦渡,入境,0,0,0,0
3/11/2020,十一,文錦渡,出境,0,0,0,0
3/11/2020,十一,沙頭角,入境,0,0,0,0
3/11/2020,十一,沙頭角,出境,0,0,0,0
3/11/2020,十一,深圳灣,入境,723,137,2,862
3/11/2020,十一,深圳灣,出境,776,85,7,868
3/11/2020,十一,中國客運碼頭,入境,0,0,0,0
3/11/2020,十一,中國客運碼頭,出境,0,0,0,0
3/11/2020,十一,港口管制,入境,0,0,0,0
3/11/2020,十一,港口管制,出境,0,0,0,0
3/11/2020,十一,啟德郵輪碼頭,入境,0,0,0,0
3/11/2020,十一,啟德郵輪碼頭,出境,0,0,0,0
3/11/2020,十一,港澳客輪碼頭,入境,0,0,0,0
3/11/2020,十一,港澳客輪碼頭,出境,0,0,0,0
3/11/2020,十一,屯門客運碼頭,入境,0,0,0,0
3/11/2020,十一,屯門客運碼頭,出境,0,0,0,0
4/11/2020,十一,機場,入境,829,7,33,869
4/11/2020,十一,機場,出境,819,6,124,949
4/11/2020,十一,高鐵西九龍,入境,0,0,0,0
4/11/2020,十一,高鐵西九龍,出境,0,0,0,0
4/11/2020,十一,紅磡,入境,0,0,0,0
4/11/2020,十一,紅磡,出境,0,0,0,0
4/11/2020,十一,羅湖,入境,0,0,0,0
4/11/2020,十一,羅湖,出境,0,0,0,0
4/11/2020,十一,落馬洲支線,入境,0,0,0,0
4/11/2020,十一,落馬洲支線,出境,0,0,0,0
4/11/2020,十一,香園圍,入境,0,0,0,0
4/11/2020,十一,香園圍,出境,0,0,0,0
4/11/2020,十一,港珠澳大橋,入境,61,2,30,93
4/11/2020,十一,港珠澳大橋,出境,158,14,5,177
4/11/2020,十一,落馬洲,入境,0,0,0,0
4/11/2020,十一,落馬洲,出境,0,0,0,0
4/11/2020,十一,文錦渡,入境,0,0,0,0
4/11/2020,十一,文錦渡,出境,0,0,0,0
4/11/2020,十一,沙頭角,入境,0,0,0,0
4/11/2020,十一,沙頭角,出境,0,0,0,0
4/11/2020,十一,深圳灣,入境,664,111,3,778
4/11/2020,十一,深圳灣,出境,742,97,8,847
4/11/2020,十一,中國客運碼頭,入境,0,0,0,0
4/11/2020,十一,中國客運碼頭,出境,0,0,0,0
4/11/2020,十一,港口管制,入境,0,0,0,0
4/11/2020,十一,港口管制,出境,0,0,0,0
4/11/2020,十一,啟德郵輪碼頭,入境,0,0,0,0
4/11/2020,十一,啟德郵輪碼頭,出境,0,0,0,0
4/11/2020,十一,港澳客輪碼頭,入境,0,0,0,0
4/11/2020,十一,港澳客輪碼頭,出境,0,0,0,0
4/11/2020,十一,屯門客運碼頭,入境,0,0,0,0
4/11/2020,十一,屯門客運碼頭,出境,0,0,0,0
5/11/2020,十一,機場,入境,1007,1,30,1038
5/11/2020,十一,機場,出境,560,3,84,647
5/11/2020,十一,高鐵西九龍,入境,0,0,0,0
5/11/2020,十一,高鐵西九龍,出境,0,0,0,0
5/11/2020,十一,紅磡,入境,0,0,0,0
5/11/2020,十一,紅磡,出境,0,0,0,0
5/11/2020,十一,羅湖,入境,0,0,0,0
5/11/2020,十一,羅湖,出境,0,0,0,0
5/11/2020,十一,落馬洲支線,入境,0,0,0,0
5/11/2020,十一,落馬洲支線,出境,0,0,0,0
5/11/2020,十一,香園圍,入境,0,0,0,0
5/11/2020,十一,香園圍,出境,0,0,0,0
5/11/2020,十一,港珠澳大橋,入境,69,5,61,135
5/11/2020,十一,港珠澳大橋,出境,109,10,5,124
5/11/2020,十一,落馬洲,入境,0,0,0,0
5/11/2020,十一,落馬洲,出境,0,0,0,0
5/11/2020,十一,文錦渡,入境,0,0,0,0
5/11/2020,十一,文錦渡,出境,0,0,0,0
5/11/2020,十一,沙頭角,入境,0,0,0,0
5/11/2020,十一,沙頭角,出境,0,0,0,0
5/11/2020,十一,深圳灣,入境,691,92,1,784
5/11/2020,十一,深圳灣,出境,631,109,5,745
5/11/2020,十一,中國客運碼頭,入境,0,0,0,0
5/11/2020,十一,中國客運碼頭,出境,0,0,0,0
5/11/2020,十一,港口管制,入境,0,0,0,0
5/11/2020,十一,港口管制,出境,0,0,0,0
5/11/2020,十一,啟德郵輪碼頭,入境,0,0,0,0
5/11/2020,十一,啟德郵輪碼頭,出境,0,0,0,0
5/11/2020,十一,港澳客輪碼頭,入境,0,0,0,0
5/11/2020,十一,港澳客輪碼頭,出境,0,0,0,0
5/11/2020,十一,屯門客運碼頭,入境,0,0,0,0
5/11/2020,十一,屯門客運碼頭,出境,0,0,0,0
6/11/2020,十一,機場,入境,931,5,40,976
6/11/2020,十一,機場,出境,832,10,55,897
6/11/2020,十一,高鐵西九龍,入境,0,0,0,0
6/11/2020,十一,高鐵西九龍,出境,0,0,0,0
6/11/2020,十一,紅磡,入境,0,0,0,0
6/11/2020,十一,紅磡,出境,0,0,0,0
6/11/2020,十一,羅湖,入境,0,0,0,0
6/11/2020,十一,羅湖,出境,0,0,0,0
6/11/2020,十一,落馬洲支線,入境,0,0,0,0
6/11/2020,十一,落馬洲支線,出境,0,0,0,0
6/11/2020,十一,香園圍,入境,0,0,0,0
6/11/2020,十一,香園圍,出境,0,0,0,0
6/11/2020,十一,港珠澳大橋,入境,58,1,7,66
6/11/2020,十一,港珠澳大橋,出境,59,10,6,75
6/11/2020,十一,落馬洲,入境,0,0,0,0
6/11/2020,十一,落馬洲,出境,0,0,0,0
6/11/2020,十一,文錦渡,入境,0,0,0,0
6/11/2020,十一,文錦渡,出境,0,0,0,0
6/11/2020,十一,沙頭角,入境,0,0,0,0
6/11/2020,十一,沙頭角,出境,0,0,0,0
6/11/2020,十一,深圳灣,入境,669,96,2,767
6/11/2020,十一,深圳灣,出境,603,86,7,696
6/11/2020,十一,中國客運碼頭,入境,0,0,0,0
6/11/2020,十一,中國客運碼頭,出境,0,0,0,0
6/11/2020,十一,港口管制,入境,0,0,0,0
6/11/2020,十一,港口管制,出境,0,0,0,0
6/11/2020,十一,啟德郵輪碼頭,入境,0,0,0,0
6/11/2020,十一,啟德郵輪碼頭,出境,0,0,0,0
6/11/2020,十一,港澳客輪碼頭,入境,0,0,0,0
6/11/2020,十一,港澳客輪碼頭,出境,0,0,0,0
6/11/2020,十一,屯門客運碼頭,入境,0,0,0,0
6/11/2020,十一,屯門客運碼頭,出境,0,0,0,0
7/11/2020,十一,機場,入境,876,8,26,910
7/11/2020,十一,機場,出境,738,9,28,775
7/11/2020,十一,高鐵西九龍,入境,0,0,0,0
7/11/2020,十一,高鐵西九龍,出境,0,0,0,0
7/11/2020,十一,紅磡,入境,0,0,0,0
7/11/2020,十一,紅磡,出境,0,0,0,0
7/11/2020,十一,羅湖,入境,0,0,0,0
7/11/2020,十一,羅湖,出境,0,0,0,0
7/11/2020,十一,落馬洲支線,入境,0,0,0,0
7/11/2020,十一,落馬洲支線,出境,0,0,0,0
7/11/2020,十一,香園圍,入境,0,0,0,0
7/11/2020,十一,香園圍,出境,0,0,0,0
7/11/2020,十一,港珠澳大橋,入境,36,3,0,39
7/11/2020,十一,港珠澳大橋,出境,92,12,4,108
7/11/2020,十一,落馬洲,入境,0,0,0,0
7/11/2020,十一,落馬洲,出境,0,0,0,0
7/11/2020,十一,文錦渡,入境,0,0,0,0
7/11/2020,十一,文錦渡,出境,0,0,0,0
7/11/2020,十一,沙頭角,入境,0,0,0,0
7/11/2020,十一,沙頭角,出境,0,0,0,0
7/11/2020,十一,深圳灣,入境,702,117,2,821
7/11/2020,十一,深圳灣,出境,467,69,3,539
7/11/2020,十一,中國客運碼頭,入境,0,0,0,0
7/11/2020,十一,中國客運碼頭,出境,0,0,0,0
7/11/2020,十一,港口管制,入境,0,0,0,0
7/11/2020,十一,港口管制,出境,0,0,0,0
7/11/2020,十一,啟德郵輪碼頭,入境,0,0,0,0
7/11/2020,十一,啟德郵輪碼頭,出境,0,0,0,0
7/11/2020,十一,港澳客輪碼頭,入境,0,0,0,0
7/11/2020,十一,港澳客輪碼頭,出境,0,0,0,0
7/11/2020,十一,屯門客運碼頭,入境,0,0,0,0
7/11/2020,十一,屯門客運碼頭,出境,0,0,0,0
8/11/2020,十一,機場,入境,1089,4,63,1156
8/11/2020,十一,機場,出境,816,22,60,898
8/11/2020,十一,高鐵西九龍,入境,0,0,0,0
8/11/2020,十一,高鐵西九龍,出境,0,0,0,0
8/11/2020,十一,紅磡,入境,0,0,0,0
8/11/2020,十一,紅磡,出境,0,0,0,0
8/11/2020,十一,羅湖,入境,0,0,0,0
8/11/2020,十一,羅湖,出境,0,0,0,0
8/11/2020,十一,落馬洲支線,入境,0,0,0,0
8/11/2020,十一,落馬洲支線,出境,0,0,0,0
8/11/2020,十一,香園圍,入境,0,0,0,0
8/11/2020,十一,香園圍,出境,0,0,0,0
8/11/2020,十一,港珠澳大橋,入境,64,4,3,71
8/11/2020,十一,港珠澳大橋,出境,67,32,1,100
8/11/2020,十一,落馬洲,入境,0,0,0,0
8/11/2020,十一,落馬洲,出境,0,0,0,0
8/11/2020,十一,文錦渡,入境,0,0,0,0
8/11/2020,十一,文錦渡,出境,0,0,0,0
8/11/2020,十一,沙頭角,入境,0,0,0,0
8/11/2020,十一,沙頭角,出境,0,0,0,0
8/11/2020,十一,深圳灣,入境,906,130,2,1038
8/11/2020,十一,深圳灣,出境,339,78,3,420
8/11/2020,十一,中國客運碼頭,入境,0,0,0,0
8/11/2020,十一,中國客運碼頭,出境,0,0,0,0
8/11/2020,十一,港口管制,入境,0,0,0,0
8/11/2020,十一,港口管制,出境,0,0,0,0
8/11/2020,十一,啟德郵輪碼頭,入境,0,0,0,0
8/11/2020,十一,啟德郵輪碼頭,出境,0,0,0,0
8/11/2020,十一,港澳客輪碼頭,入境,0,0,0,0
8/11/2020,十一,港澳客輪碼頭,出境,0,0,0,0
8/11/2020,十一,屯門客運碼頭,入境,0,0,0,0
8/11/2020,十一,屯門客運碼頭,出境,0,0,0,0
9/11/2020,十一,機場,入境,621,0,19,640
9/11/2020,十一,機場,出境,379,13,20,412
9/11/2020,十一,高鐵西九龍,入境,0,0,0,0
9/11/2020,十一,高鐵西九龍,出境,0,0,0,0
9/11/2020,十一,紅磡,入境,0,0,0,0
9/11/2020,十一,紅磡,出境,0,0,0,0
9/11/2020,十一,羅湖,入境,0,0,0,0
9/11/2020,十一,羅湖,出境,0,0,0,0
9/11/2020,十一,落馬洲支線,入境,0,0,0,0
9/11/2020,十一,落馬洲支線,出境,0,0,0,0
9/11/2020,十一,香園圍,入境,0,0,0,0
9/11/2020,十一,香園圍,出境,0,0,0,0
9/11/2020,十一,港珠澳大橋,入境,62,5,5,72
9/11/2020,十一,港珠澳大橋,出境,62,3,5,70
9/11/2020,十一,落馬洲,入境,0,0,0,0
9/11/2020,十一,落馬洲,出境,0,0,0,0
9/11/2020,十一,文錦渡,入境,0,0,0,0
9/11/2020,十一,文錦渡,出境,0,0,0,0
9/11/2020,十一,沙頭角,入境,0,0,0,0
9/11/2020,十一,沙頭角,出境,0,0,0,0
9/11/2020,十一,深圳灣,入境,773,85,1,859
9/11/2020,十一,深圳灣,出境,352,53,3,408
9/11/2020,十一,中國客運碼頭,入境,0,0,0,0
9/11/2020,十一,中國客運碼頭,出境,0,0,0,0
9/11/2020,十一,港口管制,入境,0,0,0,0
9/11/2020,十一,港口管制,出境,0,0,0,0
9/11/2020,十一,啟德郵輪碼頭,入境,0,0,0,0
9/11/2020,十一,啟德郵輪碼頭,出境,0,0,0,0
9/11/2020,十一,港澳客輪碼頭,入境,0,0,0,0
9/11/2020,十一,港澳客輪碼頭,出境,0,0,0,0
9/11/2020,十一,屯門客運碼頭,入境,0,0,0,0
9/11/2020,十一,屯門客運碼頭,出境,0,0,0,0
10/11/2020,十一,機場,入境,952,6,36,994
10/11/2020,十一,機場,出境,964,20,36,1020
10/11/2020,十一,高鐵西九龍,入境,0,0,0,0
10/11/2020,十一,高鐵西九龍,出境,0,0,0,0
10/11/2020,十一,紅磡,入境,0,0,0,0
10/11/2020,十一,紅磡,出境,0,0,0,0
10/11/2020,十一,羅湖,入境,0,0,0,0
10/11/2020,十一,羅湖,出境,0,0,0,0
10/11/2020,十一,落馬洲支線,入境,0,0,0,0
10/11/2020,十一,落馬洲支線,出境,0,0,0,0
10/11/2020,十一,香園圍,入境,0,0,0,0
10/11/2020,十一,香園圍,出境,0,0,0,0
10/11/2020,十一,港珠澳大橋,入境,83,4,6,93
10/11/2020,十一,港珠澳大橋,出境,114,6,3,123
10/11/2020,十一,落馬洲,入境,0,0,0,0
10/11/2020,十一,落馬洲,出境,0,0,0,0
10/11/2020,十一,文錦渡,入境,0,0,0,0
10/11/2020,十一,文錦渡,出境,0,0,0,0
10/11/2020,十一,沙頭角,入境,0,0,0,0
10/11/2020,十一,沙頭角,出境,0,0,0,0
10/11/2020,十一,深圳灣,入境,736,93,2,831
10/11/2020,十一,深圳灣,出境,739,82,10,831
10/11/2020,十一,中國客運碼頭,入境,0,0,0,0
10/11/2020,十一,中國客運碼頭,出境,0,0,0,0
10/11/2020,十一,港口管制,入境,0,0,0,0
10/11/2020,十一,港口管制,出境,0,0,0,0
10/11/2020,十一,啟德郵輪碼頭,入境,0,0,0,0
10/11/2020,十一,啟德郵輪碼頭,出境,0,0,0,0
10/11/2020,十一,港澳客輪碼頭,入境,0,0,0,0
10/11/2020,十一,港澳客輪碼頭,出境,0,0,0,0
10/11/2020,十一,屯門客運碼頭,入境,0,0,0,0
10/11/2020,十一,屯門客運碼頭,出境,0,0,0,0
11/11/2020,十一,機場,入境,1321,2,52,1375
11/11/2020,十一,機場,出境,508,8,42,558
11/11/2020,十一,高鐵西九龍,入境,0,0,0,0
11/11/2020,十一,高鐵西九龍,出境,0,0,0,0
11/11/2020,十一,紅磡,入境,0,0,0,0
11/11/2020,十一,紅磡,出境,0,0,0,0
11/11/2020,十一,羅湖,入境,0,0,0,0
11/11/2020,十一,羅湖,出境,0,0,0,0
11/11/2020,十一,落馬洲支線,入境,0,0,0,0
11/11/2020,十一,落馬洲支線,出境,0,0,0,0
11/11/2020,十一,香園圍,入境,0,0,0,0
11/11/2020,十一,香園圍,出境,0,0,0,0
11/11/2020,十一,港珠澳大橋,入境,44,4,4,52
11/11/2020,十一,港珠澳大橋,出境,94,7,1,102
11/11/2020,十一,落馬洲,入境,0,0,0,0
11/11/2020,十一,落馬洲,出境,0,0,0,0
11/11/2020,十一,文錦渡,入境,0,0,0,0
11/11/2020,十一,文錦渡,出境,0,0,0,0
11/11/2020,十一,沙頭角,入境,0,0,0,0
11/11/2020,十一,沙頭角,出境,0,0,0,0
11/11/2020,十一,深圳灣,入境,658,88,3,749
11/11/2020,十一,深圳灣,出境,676,84,3,763
11/11/2020,十一,中國客運碼頭,入境,0,0,0,0
11/11/2020,十一,中國客運碼頭,出境,0,0,0,0
11/11/2020,十一,港口管制,入境,0,0,0,0
11/11/2020,十一,港口管制,出境,0,0,0,0
11/11/2020,十一,啟德郵輪碼頭,入境,0,0,0,0
11/11/2020,十一,啟德郵輪碼頭,出境,0,0,0,0
11/11/2020,十一,港澳客輪碼頭,入境,0,0,0,0
11/11/2020,十一,港澳客輪碼頭,出境,0,0,0,0
11/11/2020,十一,屯門客運碼頭,入境,0,0,0,0
11/11/2020,十一,屯門客運碼頭,出境,0,0,0,0
12/11/2020,十一,機場,入境,1646,4,61,1711
12/11/2020,十一,機場,出境,589,7,74,670
12/11/2020,十一,高鐵西九龍,入境,0,0,0,0
12/11/2020,十一,高鐵西九龍,出境,0,0,0,0
12/11/2020,十一,紅磡,入境,0,0,0,0
12/11/2020,十一,紅磡,出境,0,0,0,0
12/11/2020,十一,羅湖,入境,0,0,0,0
12/11/2020,十一,羅湖,出境,0,0,0,0
12/11/2020,十一,落馬洲支線,入境,0,0,0,0
12/11/2020,十一,落馬洲支線,出境,0,0,0,0
12/11/2020,十一,香園圍,入境,0,0,0,0
12/11/2020,十一,香園圍,出境,0,0,0,0
12/11/2020,十一,港珠澳大橋,入境,54,1,22,77
12/11/2020,十一,港珠澳大橋,出境,101,7,3,111
12/11/2020,十一,落馬洲,入境,0,0,0,0
12/11/2020,十一,落馬洲,出境,0,0,0,0
12/11/2020,十一,文錦渡,入境,0,0,0,0
12/11/2020,十一,文錦渡,出境,0,0,0,0
12/11/2020,十一,沙頭角,入境,0,0,0,0
12/11/2020,十一,沙頭角,出境,0,0,0,0
12/11/2020,十一,深圳灣,入境,616,102,4,722
12/11/2020,十一,深圳灣,出境,587,67,4,658
12/11/2020,十一,中國客運碼頭,入境,0,0,0,0
12/11/2020,十一,中國客運碼頭,出境,0,0,0,0
12/11/2020,十一,港口管制,入境,0,0,0,0
12/11/2020,十一,港口管制,出境,0,0,0,0
12/11/2020,十一,啟德郵輪碼頭,入境,0,0,0,0
12/11/2020,十一,啟德郵輪碼頭,出境,0,0,0,0
12/11/2020,十一,港澳客輪碼頭,入境,0,0,0,0
12/11/2020,十一,港澳客輪碼頭,出境,0,0,0,0
12/11/2020,十一,屯門客運碼頭,入境,0,0,0,0
12/11/2020,十一,屯門客運碼頭,出境,0,0,0,0
13/11/2020,十一,機場,入境,806,1,26,833
13/11/2020,十一,機場,出境,706,8,49,763
13/11/2020,十一,高鐵西九龍,入境,0,0,0,0
13/11/2020,十一,高鐵西九龍,出境,0,0,0,0
13/11/2020,十一,紅磡,入境,0,0,0,0
13/11/2020,十一,紅磡,出境,0,0,0,0
13/11/2020,十一,羅湖,入境,0,0,0,0
13/11/2020,十一,羅湖,出境,0,0,0,0
13/11/2020,十一,落馬洲支線,入境,0,0,0,0
13/11/2020,十一,落馬洲支線,出境,0,0,0,0
13/11/2020,十一,香園圍,入境,0,0,0,0
13/11/2020,十一,香園圍,出境,0,0,0,0
13/11/2020,十一,港珠澳大橋,入境,46,7,3,56
13/11/2020,十一,港珠澳大橋,出境,109,10,6,125
13/11/2020,十一,落馬洲,入境,0,0,0,0
13/11/2020,十一,落馬洲,出境,0,0,0,0
13/11/2020,十一,文錦渡,入境,0,0,0,0
13/11/2020,十一,文錦渡,出境,0,0,0,0
13/11/2020,十一,沙頭角,入境,0,0,0,0
13/11/2020,十一,沙頭角,出境,0,0,0,0
13/11/2020,十一,深圳灣,入境,604,99,2,705
13/11/2020,十一,深圳灣,出境,569,68,7,644
13/11/2020,十一,中國客運碼頭,入境,0,0,0,0
13/11/2020,十一,中國客運碼頭,出境,0,0,0,0
13/11/2020,十一,港口管制,入境,0,0,0,0
13/11/2020,十一,港口管制,出境,0,0,0,0
13/11/2020,十一,啟德郵輪碼頭,入境,0,0,0,0
13/11/2020,十一,啟德郵輪碼頭,出境,0,0,0,0
13/11/2020,十一,港澳客輪碼頭,入境,0,0,0,0
13/11/2020,十一,港澳客輪碼頭,出境,0,0,0,0
13/11/2020,十一,屯門客運碼頭,入境,0,0,0,0
13/11/2020,十一,屯門客運碼頭,出境,0,0,0,0
14/11/2020,十一,機場,入境,714,3,19,736
14/11/2020,十一,機場,出境,885,15,34,934
14/11/2020,十一,高鐵西九龍,入境,0,0,0,0
14/11/2020,十一,高鐵西九龍,出境,0,0,0,0
14/11/2020,十一,紅磡,入境,0,0,0,0
14/11/2020,十一,紅磡,出境,0,0,0,0
14/11/2020,十一,羅湖,入境,0,0,0,0
14/11/2020,十一,羅湖,出境,0,0,0,0
14/11/2020,十一,落馬洲支線,入境,0,0,0,0
14/11/2020,十一,落馬洲支線,出境,0,0,0,0
14/11/2020,十一,香園圍,入境,0,0,0,0
14/11/2020,十一,香園圍,出境,0,0,0,0
14/11/2020,十一,港珠澳大橋,入境,47,4,1,52
14/11/2020,十一,港珠澳大橋,出境,107,6,2,115
14/11/2020,十一,落馬洲,入境,0,0,0,0
14/11/2020,十一,落馬洲,出境,0,0,0,0
14/11/2020,十一,文錦渡,入境,0,0,0,0
14/11/2020,十一,文錦渡,出境,0,0,0,0
14/11/2020,十一,沙頭角,入境,0,0,0,0
14/11/2020,十一,沙頭角,出境,0,0,0,0
14/11/2020,十一,深圳灣,入境,525,112,6,643
14/11/2020,十一,深圳灣,出境,540,64,2,606
14/11/2020,十一,中國客運碼頭,入境,0,0,0,0
14/11/2020,十一,中國客運碼頭,出境,0,0,0,0
14/11/2020,十一,港口管制,入境,0,0,0,0
14/11/2020,十一,港口管制,出境,0,0,0,0
14/11/2020,十一,啟德郵輪碼頭,入境,0,0,0,0
14/11/2020,十一,啟德郵輪碼頭,出境,0,0,0,0
14/11/2020,十一,港澳客輪碼頭,入境,0,0,0,0
14/11/2020,十一,港澳客輪碼頭,出境,0,0,0,0
14/11/2020,十一,屯門客運碼頭,入境,0,0,0,0
14/11/2020,十一,屯門客運碼頭,出境,0,0,0,0
15/11/2020,十一,機場,入境,969,6,38,1013
15/11/2020,十一,機場,出境,1174,30,55,1259
15/11/2020,十一,高鐵西九龍,入境,0,0,0,0
15/11/2020,十一,高鐵西九龍,出境,0,0,0,0
15/11/2020,十一,紅磡,入境,0,0,0,0
15/11/2020,十一,紅磡,出境,0,0,0,0
15/11/2020,十一,羅湖,入境,0,0,0,0
15/11/2020,十一,羅湖,出境,0,0,0,0
15/11/2020,十一,落馬洲支線,入境,0,0,0,0
15/11/2020,十一,落馬洲支線,出境,0,0,0,0
15/11/2020,十一,香園圍,入境,0,0,0,0
15/11/2020,十一,香園圍,出境,0,0,0,0
15/11/2020,十一,港珠澳大橋,入境,34,4,6,44
15/11/2020,十一,港珠澳大橋,出境,62,8,0,70
15/11/2020,十一,落馬洲,入境,0,0,0,0
15/11/2020,十一,落馬洲,出境,0,0,0,0
15/11/2020,十一,文錦渡,入境,0,0,0,0
15/11/2020,十一,文錦渡,出境,0,0,0,0
15/11/2020,十一,沙頭角,入境,0,0,0,0
15/11/2020,十一,沙頭角,出境,0,0,0,0
15/11/2020,十一,深圳灣,入境,742,114,2,858
15/11/2020,十一,深圳灣,出境,358,50,1,409
15/11/2020,十一,中國客運碼頭,入境,0,0,0,0
15/11/2020,十一,中國客運碼頭,出境,0,0,0,0
15/11/2020,十一,港口管制,入境,0,0,0,0
15/11/2020,十一,港口管制,出境,0,0,0,0
15/11/2020,十一,啟德郵輪碼頭,入境,0,0,0,0
15/11/2020,十一,啟德郵輪碼頭,出境,0,0,0,0
15/11/2020,十一,港澳客輪碼頭,入境,0,0,0,0
15/11/2020,十一,港澳客輪碼頭,出境,0,0,0,0
15/11/2020,十一,屯門客運碼頭,入境,0,0,0,0
15/11/2020,十一,屯門客運碼頭,出境,0,0,0,0
16/11/2020,十一,機場,入境,366,14,17,397
16/11/2020,十一,機場,出境,424,13,14,451
16/11/2020,十一,高鐵西九龍,入境,0,0,0,0
16/11/2020,十一,高鐵西九龍,出境,0,0,0,0
16/11/2020,十一,紅磡,入境,0,0,0,0
16/11/2020,十一,紅磡,出境,0,0,0,0
16/11/2020,十一,羅湖,入境,0,0,0,0
16/11/2020,十一,羅湖,出境,0,0,0,0
16/11/2020,十一,落馬洲支線,入境,0,0,0,0
16/11/2020,十一,落馬洲支線,出境,0,0,0,0
16/11/2020,十一,香園圍,入境,0,0,0,0
16/11/2020,十一,香園圍,出境,0,0,0,0
16/11/2020,十一,港珠澳大橋,入境,38,5,2,45
16/11/2020,十一,港珠澳大橋,出境,196,13,4,213
16/11/2020,十一,落馬洲,入境,0,0,0,0
16/11/2020,十一,落馬洲,出境,0,0,0,0
16/11/2020,十一,文錦渡,入境,0,0,0,0
16/11/2020,十一,文錦渡,出境,0,0,0,0
16/11/2020,十一,沙頭角,入境,0,0,0,0
16/11/2020,十一,沙頭角,出境,0,0,0,0
16/11/2020,十一,深圳灣,入境,550,91,3,644
16/11/2020,十一,深圳灣,出境,1046,109,0,1155
16/11/2020,十一,中國客運碼頭,入境,0,0,0,0
16/11/2020,十一,中國客運碼頭,出境,0,0,0,0
16/11/2020,十一,港口管制,入境,0,0,0,0
16/11/2020,十一,港口管制,出境,0,0,0,0
16/11/2020,十一,啟德郵輪碼頭,入境,0,0,0,0
16/11/2020,十一,啟德郵輪碼頭,出境,0,0,0,0
16/11/2020,十一,港澳客輪碼頭,入境,0,0,0,0
16/11/2020,十一,港澳客輪碼頭,出境,0,0,0,0
16/11/2020,十一,屯門客運碼頭,入境,0,0,0,0
16/11/2020,十一,屯門客運碼頭,出境,0,0,0,0
17/11/2020,十一,機場,入境,385,4,26,415
17/11/2020,十一,機場,出境,611,14,32,657
17/11/2020,十一,高鐵西九龍,入境,0,0,0,0
17/11/2020,十一,高鐵西九龍,出境,0,0,0,0
17/11/2020,十一,紅磡,入境,0,0,0,0
17/11/2020,十一,紅磡,出境,0,0,0,0
17/11/2020,十一,羅湖,入境,0,0,0,0
17/11/2020,十一,羅湖,出境,0,0,0,0
17/11/2020,十一,落馬洲支線,入境,0,0,0,0
17/11/2020,十一,落馬洲支線,出境,0,0,0,0
17/11/2020,十一,香園圍,入境,0,0,0,0
17/11/2020,十一,香園圍,出境,0,0,0,0
17/11/2020,十一,港珠澳大橋,入境,21,6,6,33
17/11/2020,十一,港珠澳大橋,出境,213,12,5,230
17/11/2020,十一,落馬洲,入境,0,0,0,0
17/11/2020,十一,落馬洲,出境,0,0,0,0
17/11/2020,十一,文錦渡,入境,0,0,0,0
17/11/2020,十一,文錦渡,出境,0,0,0,0
17/11/2020,十一,沙頭角,入境,0,0,0,0
17/11/2020,十一,沙頭角,出境,0,0,0,0
17/11/2020,十一,深圳灣,入境,490,86,3,579
17/11/2020,十一,深圳灣,出境,1340,166,1,1507
17/11/2020,十一,中國客運碼頭,入境,0,0,0,0
17/11/2020,十一,中國客運碼頭,出境,0,0,0,0
17/11/2020,十一,港口管制,入境,0,0,0,0
17/11/2020,十一,港口管制,出境,0,0,0,0
17/11/2020,十一,啟德郵輪碼頭,入境,0,0,0,0
17/11/2020,十一,啟德郵輪碼頭,出境,0,0,0,0
17/11/2020,十一,港澳客輪碼頭,入境,0,0,0,0
17/11/2020,十一,港澳客輪碼頭,出境,0,0,0,0
17/11/2020,十一,屯門客運碼頭,入境,0,0,0,0
17/11/2020,十一,屯門客運碼頭,出境,0,0,0,0
18/11/2020,十一,機場,入境,609,6,27,642
18/11/2020,十一,機場,出境,763,5,86,854
18/11/2020,十一,高鐵西九龍,入境,0,0,0,0
18/11/2020,十一,高鐵西九龍,出境,0,0,0,0
18/11/2020,十一,紅磡,入境,0,0,0,0
18/11/2020,十一,紅磡,出境,0,0,0,0
18/11/2020,十一,羅湖,入境,0,0,0,0
18/11/2020,十一,羅湖,出境,0,0,0,0
18/11/2020,十一,落馬洲支線,入境,0,0,0,0
18/11/2020,十一,落馬洲支線,出境,0,0,0,0
18/11/2020,十一,香園圍,入境,0,0,0,0
18/11/2020,十一,香園圍,出境,0,0,0,0
18/11/2020,十一,港珠澳大橋,入境,14,3,19,36
18/11/2020,十一,港珠澳大橋,出境,159,10,6,175
18/11/2020,十一,落馬洲,入境,0,0,0,0
18/11/2020,十一,落馬洲,出境,0,0,0,0
18/11/2020,十一,文錦渡,入境,0,0,0,0
18/11/2020,十一,文錦渡,出境,0,0,0,0
18/11/2020,十一,沙頭角,入境,0,0,0,0
18/11/2020,十一,沙頭角,出境,0,0,0,0
18/11/2020,十一,深圳灣,入境,407,86,0,493
18/11/2020,十一,深圳灣,出境,1039,156,8,1203
18/11/2020,十一,中國客運碼頭,入境,0,0,0,0
18/11/2020,十一,中國客運碼頭,出境,0,0,0,0
18/11/2020,十一,港口管制,入境,0,0,0,0
18/11/2020,十一,港口管制,出境,0,0,0,0
18/11/2020,十一,啟德郵輪碼頭,入境,0,0,0,0
18/11/2020,十一,啟德郵輪碼頭,出境,0,0,0,0
18/11/2020,十一,港澳客輪碼頭,入境,0,0,0,0
18/11/2020,十一,港澳客輪碼頭,出境,0,0,0,0
18/11/2020,十一,屯門客運碼頭,入境,0,0,0,0
18/11/2020,十一,屯門客運碼頭,出境,0,0,0,0
19/11/2020,十一,機場,入境,568,2,30,600
19/11/2020,十一,機場,出境,550,5,36,591
19/11/2020,十一,高鐵西九龍,入境,0,0,0,0
19/11/2020,十一,高鐵西九龍,出境,0,0,0,0
19/11/2020,十一,紅磡,入境,0,0,0,0
19/11/2020,十一,紅磡,出境,0,0,0,0
19/11/2020,十一,羅湖,入境,0,0,0,0
19/11/2020,十一,羅湖,出境,0,0,0,0
19/11/2020,十一,落馬洲支線,入境,0,0,0,0
19/11/2020,十一,落馬洲支線,出境,0,0,0,0
19/11/2020,十一,香園圍,入境,0,0,0,0
19/11/2020,十一,香園圍,出境,0,0,0,0
19/11/2020,十一,港珠澳大橋,入境,19,0,3,22
19/11/2020,十一,港珠澳大橋,出境,144,15,6,165
19/11/2020,十一,落馬洲,入境,0,0,0,0
19/11/2020,十一,落馬洲,出境,0,0,0,0
19/11/2020,十一,文錦渡,入境,0,0,0,0
19/11/2020,十一,文錦渡,出境,0,0,0,0
19/11/2020,十一,沙頭角,入境,0,0,0,0
19/11/2020,十一,沙頭角,出境,0,0,0,0
19/11/2020,十一,深圳灣,入境,359,95,0,454
19/11/2020,十一,深圳灣,出境,985,128,3,1116
19/11/2020,十一,中國客運碼頭,入境,0,0,0,0
19/11/2020,十一,中國客運碼頭,出境,0,0,0,0
19/11/2020,十一,港口管制,入境,0,0,0,0
19/11/2020,十一,港口管制,出境,0,0,0,0
19/11/2020,十一,啟德郵輪碼頭,入境,0,0,0,0
19/11/2020,十一,啟德郵輪碼頭,出境,0,0,0,0
19/11/2020,十一,港澳客輪碼頭,入境,0,0,0,0
19/11/2020,十一,港澳客輪碼頭,出境,0,0,0,0
19/11/2020,十一,屯門客運碼頭,入境,0,0,0,0
19/11/2020,十一,屯門客運碼頭,出境,0,0,0,0
20/11/2020,十一,機場,入境,766,12,34,812
20/11/2020,十一,機場,出境,976,27,56,1059
20/11/2020,十一,高鐵西九龍,入境,0,0,0,0
20/11/2020,十一,高鐵西九龍,出境,0,0,0,0
20/11/2020,十一,紅磡,入境,0,0,0,0
20/11/2020,十一,紅磡,出境,0,0,0,0
20/11/2020,十一,羅湖,入境,0,0,0,0
20/11/2020,十一,羅湖,出境,0,0,0,0
20/11/2020,十一,落馬洲支線,入境,0,0,0,0
20/11/2020,十一,落馬洲支線,出境,0,0,0,0
20/11/2020,十一,香園圍,入境,0,0,0,0
20/11/2020,十一,香園圍,出境,0,0,0,0
20/11/2020,十一,港珠澳大橋,入境,22,2,4,28
20/11/2020,十一,港珠澳大橋,出境,178,15,3,196
20/11/2020,十一,落馬洲,入境,0,0,0,0
20/11/2020,十一,落馬洲,出境,0,0,0,0
20/11/2020,十一,文錦渡,入境,0,0,0,0
20/11/2020,十一,文錦渡,出境,0,0,0,0
20/11/2020,十一,沙頭角,入境,0,0,0,0
20/11/2020,十一,沙頭角,出境,0,0,0,0
20/11/2020,十一,深圳灣,入境,490,73,1,564
20/11/2020,十一,深圳灣,出境,1073,138,4,1215
20/11/2020,十一,中國客運碼頭,入境,0,0,0,0
20/11/2020,十一,中國客運碼頭,出境,0,0,0,0
20/11/2020,十一,港口管制,入境,0,0,0,0
20/11/2020,十一,港口管制,出境,0,0,0,0
20/11/2020,十一,啟德郵輪碼頭,入境,0,0,0,0
20/11/2020,十一,啟德郵輪碼頭,出境,0,0,0,0
20/11/2020,十一,港澳客輪碼頭,入境,0,0,0,0
20/11/2020,十一,港澳客輪碼頭,出境,0,0,0,0
20/11/2020,十一,屯門客運碼頭,入境,0,0,0,0
20/11/2020,十一,屯門客運碼頭,出境,0,0,0,0
21/11/2020,十一,機場,入境,999,3,41,1043
21/11/2020,十一,機場,出境,957,21,35,1013
21/11/2020,十一,高鐵西九龍,入境,0,0,0,0
21/11/2020,十一,高鐵西九龍,出境,0,0,0,0
21/11/2020,十一,紅磡,入境,0,0,0,0
21/11/2020,十一,紅磡,出境,0,0,0,0
21/11/2020,十一,羅湖,入境,0,0,0,0
21/11/2020,十一,羅湖,出境,0,0,0,0
21/11/2020,十一,落馬洲支線,入境,0,0,0,0
21/11/2020,十一,落馬洲支線,出境,0,0,0,0
21/11/2020,十一,香園圍,入境,0,0,0,0
21/11/2020,十一,香園圍,出境,0,0,0,0
21/11/2020,十一,港珠澳大橋,入境,22,7,2,31
21/11/2020,十一,港珠澳大橋,出境,151,13,4,168
21/11/2020,十一,落馬洲,入境,0,0,0,0
21/11/2020,十一,落馬洲,出境,0,0,0,0
21/11/2020,十一,文錦渡,入境,0,0,0,0
21/11/2020,十一,文錦渡,出境,0,0,0,0
21/11/2020,十一,沙頭角,入境,0,0,0,0
21/11/2020,十一,沙頭角,出境,0,0,0,0
21/11/2020,十一,深圳灣,入境,521,113,3,637
21/11/2020,十一,深圳灣,出境,858,140,4,1002
21/11/2020,十一,中國客運碼頭,入境,0,0,0,0
21/11/2020,十一,中國客運碼頭,出境,0,0,0,0
21/11/2020,十一,港口管制,入境,0,0,0,0
21/11/2020,十一,港口管制,出境,0,0,0,0
21/11/2020,十一,啟德郵輪碼頭,入境,0,0,0,0
21/11/2020,十一,啟德郵輪碼頭,出境,0,0,0,0
21/11/2020,十一,港澳客輪碼頭,入境,0,0,0,0
21/11/2020,十一,港澳客輪碼頭,出境,0,0,0,0
21/11/2020,十一,屯門客運碼頭,入境,0,0,0,0
21/11/2020,十一,屯門客運碼頭,出境,0,0,0,0
22/11/2020,十一,機場,入境,1044,5,27,1076
22/11/2020,十一,機場,出境,904,21,70,995
22/11/2020,十一,高鐵西九龍,入境,0,0,0,0
22/11/2020,十一,高鐵西九龍,出境,0,0,0,0
22/11/2020,十一,紅磡,入境,0,0,0,0
22/11/2020,十一,紅磡,出境,0,0,0,0
22/11/2020,十一,羅湖,入境,0,0,0,0
22/11/2020,十一,羅湖,出境,0,0,0,0
22/11/2020,十一,落馬洲支線,入境,0,0,0,0
22/11/2020,十一,落馬洲支線,出境,0,0,0,0
22/11/2020,十一,香園圍,入境,0,0,0,0
22/11/2020,十一,香園圍,出境,0,0,0,0
22/11/2020,十一,港珠澳大橋,入境,23,4,5,32
22/11/2020,十一,港珠澳大橋,出境,120,14,2,136
22/11/2020,十一,落馬洲,入境,0,0,0,0
22/11/2020,十一,落馬洲,出境,0,0,0,0
22/11/2020,十一,文錦渡,入境,0,0,0,0
22/11/2020,十一,文錦渡,出境,0,0,0,0
22/11/2020,十一,沙頭角,入境,0,0,0,0
22/11/2020,十一,沙頭角,出境,0,0,0,0
22/11/2020,十一,深圳灣,入境,460,93,3,556
22/11/2020,十一,深圳灣,出境,710,123,5,838
22/11/2020,十一,中國客運碼頭,入境,0,0,0,0
22/11/2020,十一,中國客運碼頭,出境,0,0,0,0
22/11/2020,十一,港口管制,入境,0,0,0,0
22/11/2020,十一,港口管制,出境,0,0,0,0
22/11/2020,十一,啟德郵輪碼頭,入境,0,0,0,0
22/11/2020,十一,啟德郵輪碼頭,出境,0,0,0,0
22/11/2020,十一,港澳客輪碼頭,入境,0,0,0,0
22/11/2020,十一,港澳客輪碼頭,出境,0,0,0,0
22/11/2020,十一,屯門客運碼頭,入境,0,0,0,0
22/11/2020,十一,屯門客運碼頭,出境,0,0,0,0
23/11/2020,十一,機場,入境,452,3,14,469
23/11/2020,十一,機場,出境,384,1,36,421
23/11/2020,十一,高鐵西九龍,入境,0,0,0,0
23/11/2020,十一,高鐵西九龍,出境,0,0,0,0
23/11/2020,十一,紅磡,入境,0,0,0,0
23/11/2020,十一,紅磡,出境,0,0,0,0
23/11/2020,十一,羅湖,入境,0,0,0,0
23/11/2020,十一,羅湖,出境,0,0,0,0
23/11/2020,十一,落馬洲支線,入境,0,0,0,0
23/11/2020,十一,落馬洲支線,出境,0,0,0,0
23/11/2020,十一,香園圍,入境,0,0,0,0
23/11/2020,十一,香園圍,出境,0,0,0,0
23/11/2020,十一,港珠澳大橋,入境,408,2,8,418
23/11/2020,十一,港珠澳大橋,出境,124,12,1,137
23/11/2020,十一,落馬洲,入境,0,0,0,0
23/11/2020,十一,落馬洲,出境,0,0,0,0
23/11/2020,十一,文錦渡,入境,0,0,0,0
23/11/2020,十一,文錦渡,出境,0,0,0,0
23/11/2020,十一,沙頭角,入境,0,0,0,0
23/11/2020,十一,沙頭角,出境,0,0,0,0
23/11/2020,十一,深圳灣,入境,2479,97,2,2578
23/11/2020,十一,深圳灣,出境,776,104,1,881
23/11/2020,十一,中國客運碼頭,入境,0,0,0,0
23/11/2020,十一,中國客運碼頭,出境,0,0,0,0
23/11/2020,十一,港口管制,入境,0,0,0,0
23/11/2020,十一,港口管制,出境,0,0,0,0
23/11/2020,十一,啟德郵輪碼頭,入境,0,0,0,0
23/11/2020,十一,啟德郵輪碼頭,出境,0,0,0,0
23/11/2020,十一,港澳客輪碼頭,入境,0,0,0,0
23/11/2020,十一,港澳客輪碼頭,出境,0,0,0,0
23/11/2020,十一,屯門客運碼頭,入境,0,0,0,0
23/11/2020,十一,屯門客運碼頭,出境,0,0,0,0
24/11/2020,十一,機場,入境,386,3,19,408
24/11/2020,十一,機場,出境,781,15,34,830
24/11/2020,十一,高鐵西九龍,入境,0,0,0,0
24/11/2020,十一,高鐵西九龍,出境,0,0,0,0
24/11/2020,十一,紅磡,入境,0,0,0,0
24/11/2020,十一,紅磡,出境,0,0,0,0
24/11/2020,十一,羅湖,入境,0,0,0,0
24/11/2020,十一,羅湖,出境,0,0,0,0
24/11/2020,十一,落馬洲支線,入境,0,0,0,0
24/11/2020,十一,落馬洲支線,出境,0,0,0,0
24/11/2020,十一,香園圍,入境,0,0,0,0
24/11/2020,十一,香園圍,出境,0,0,0,0
24/11/2020,十一,港珠澳大橋,入境,108,2,4,114
24/11/2020,十一,港珠澳大橋,出境,206,14,8,228
24/11/2020,十一,落馬洲,入境,0,0,0,0
24/11/2020,十一,落馬洲,出境,0,0,0,0
24/11/2020,十一,文錦渡,入境,0,0,0,0
24/11/2020,十一,文錦渡,出境,0,0,0,0
24/11/2020,十一,沙頭角,入境,0,0,0,0
24/11/2020,十一,沙頭角,出境,0,0,0,0
24/11/2020,十一,深圳灣,入境,1224,67,2,1293
24/11/2020,十一,深圳灣,出境,1093,172,2,1267
24/11/2020,十一,中國客運碼頭,入境,0,0,0,0
24/11/2020,十一,中國客運碼頭,出境,0,0,0,0
24/11/2020,十一,港口管制,入境,0,0,0,0
24/11/2020,十一,港口管制,出境,0,0,0,0
24/11/2020,十一,啟德郵輪碼頭,入境,0,0,0,0
24/11/2020,十一,啟德郵輪碼頭,出境,0,0,0,0
24/11/2020,十一,港澳客輪碼頭,入境,0,0,0,0
24/11/2020,十一,港澳客輪碼頭,出境,0,0,0,0
24/11/2020,十一,屯門客運碼頭,入境,0,0,0,0
24/11/2020,十一,屯門客運碼頭,出境,0,0,0,0
25/11/2020,十一,機場,入境,520,4,16,540
25/11/2020,十一,機場,出境,625,15,31,671
25/11/2020,十一,高鐵西九龍,入境,0,0,0,0
25/11/2020,十一,高鐵西九龍,出境,0,0,0,0
25/11/2020,十一,紅磡,入境,0,0,0,0
25/11/2020,十一,紅磡,出境,0,0,0,0
25/11/2020,十一,羅湖,入境,0,0,0,0
25/11/2020,十一,羅湖,出境,0,0,0,0
25/11/2020,十一,落馬洲支線,入境,0,0,0,0
25/11/2020,十一,落馬洲支線,出境,0,0,0,0
25/11/2020,十一,香園圍,入境,0,0,0,0
25/11/2020,十一,香園圍,出境,0,0,0,0
25/11/2020,十一,港珠澳大橋,入境,150,6,5,161
25/11/2020,十一,港珠澳大橋,出境,200,16,4,220
25/11/2020,十一,落馬洲,入境,0,0,0,0
25/11/2020,十一,落馬洲,出境,0,0,0,0
25/11/2020,十一,文錦渡,入境,0,0,0,0
25/11/2020,十一,文錦渡,出境,0,0,0,0
25/11/2020,十一,沙頭角,入境,0,0,0,0
25/11/2020,十一,沙頭角,出境,0,0,0,0
25/11/2020,十一,深圳灣,入境,1229,57,6,1292
25/11/2020,十一,深圳灣,出境,1074,187,2,1263
25/11/2020,十一,中國客運碼頭,入境,0,0,0,0
25/11/2020,十一,中國客運碼頭,出境,0,0,0,0
25/11/2020,十一,港口管制,入境,0,0,0,0
25/11/2020,十一,港口管制,出境,0,0,0,0
25/11/2020,十一,啟德郵輪碼頭,入境,0,0,0,0
25/11/2020,十一,啟德郵輪碼頭,出境,0,0,0,0
25/11/2020,十一,港澳客輪碼頭,入境,0,0,0,0
25/11/2020,十一,港澳客輪碼頭,出境,0,0,0,0
25/11/2020,十一,屯門客運碼頭,入境,0,0,0,0
25/11/2020,十一,屯門客運碼頭,出境,0,0,0,0
26/11/2020,十一,機場,入境,708,2,19,729
26/11/2020,十一,機場,出境,651,13,41,705
26/11/2020,十一,高鐵西九龍,入境,0,0,0,0
26/11/2020,十一,高鐵西九龍,出境,0,0,0,0
26/11/2020,十一,紅磡,入境,0,0,0,0
26/11/2020,十一,紅磡,出境,0,0,0,0
26/11/2020,十一,羅湖,入境,0,0,0,0
26/11/2020,十一,羅湖,出境,0,0,0,0
26/11/2020,十一,落馬洲支線,入境,0,0,0,0
26/11/2020,十一,落馬洲支線,出境,0,0,0,0
26/11/2020,十一,香園圍,入境,0,0,0,0
26/11/2020,十一,香園圍,出境,0,0,0,0
26/11/2020,十一,港珠澳大橋,入境,93,2,6,101
26/11/2020,十一,港珠澳大橋,出境,186,6,3,195
26/11/2020,十一,落馬洲,入境,0,0,0,0
26/11/2020,十一,落馬洲,出境,0,0,0,0
26/11/2020,十一,文錦渡,入境,0,0,0,0
26/11/2020,十一,文錦渡,出境,0,0,0,0
26/11/2020,十一,沙頭角,入境,0,0,0,0
26/11/2020,十一,沙頭角,出境,0,0,0,0
26/11/2020,十一,深圳灣,入境,902,76,2,980
26/11/2020,十一,深圳灣,出境,1146,140,10,1296
26/11/2020,十一,中國客運碼頭,入境,0,0,0,0
26/11/2020,十一,中國客運碼頭,出境,0,0,0,0
26/11/2020,十一,港口管制,入境,0,0,0,0
26/11/2020,十一,港口管制,出境,0,0,0,0
26/11/2020,十一,啟德郵輪碼頭,入境,0,0,0,0
26/11/2020,十一,啟德郵輪碼頭,出境,0,0,0,0
26/11/2020,十一,港澳客輪碼頭,入境,0,0,0,0
26/11/2020,十一,港澳客輪碼頭,出境,0,0,0,0
26/11/2020,十一,屯門客運碼頭,入境,0,0,0,0
26/11/2020,十一,屯門客運碼頭,出境,0,0,0,0
27/11/2020,十一,機場,入境,1007,6,28,1041
27/11/2020,十一,機場,出境,1003,24,38,1065
27/11/2020,十一,高鐵西九龍,入境,0,0,0,0
27/11/2020,十一,高鐵西九龍,出境,0,0,0,0
27/11/2020,十一,紅磡,入境,0,0,0,0
27/11/2020,十一,紅磡,出境,0,0,0,0
27/11/2020,十一,羅湖,入境,0,0,0,0
27/11/2020,十一,羅湖,出境,0,0,0,0
27/11/2020,十一,落馬洲支線,入境,0,0,0,0
27/11/2020,十一,落馬洲支線,出境,0,0,0,0
27/11/2020,十一,香園圍,入境,0,0,0,0
27/11/2020,十一,香園圍,出境,0,0,0,0
27/11/2020,十一,港珠澳大橋,入境,114,3,9,126
27/11/2020,十一,港珠澳大橋,出境,209,8,2,219
27/11/2020,十一,落馬洲,入境,0,0,0,0
27/11/2020,十一,落馬洲,出境,0,0,0,0
27/11/2020,十一,文錦渡,入境,0,0,0,0
27/11/2020,十一,文錦渡,出境,0,0,0,0
27/11/2020,十一,沙頭角,入境,0,0,0,0
27/11/2020,十一,沙頭角,出境,0,0,0,0
27/11/2020,十一,深圳灣,入境,859,72,2,933
27/11/2020,十一,深圳灣,出境,1235,170,4,1409
27/11/2020,十一,中國客運碼頭,入境,0,0,0,0
27/11/2020,十一,中國客運碼頭,出境,0,0,0,0
27/11/2020,十一,港口管制,入境,0,0,0,0
27/11/2020,十一,港口管制,出境,0,0,0,0
27/11/2020,十一,啟德郵輪碼頭,入境,0,0,0,0
27/11/2020,十一,啟德郵輪碼頭,出境,0,0,0,0
27/11/2020,十一,港澳客輪碼頭,入境,0,0,0,0
27/11/2020,十一,港澳客輪碼頭,出境,0,0,0,0
27/11/2020,十一,屯門客運碼頭,入境,0,0,0,0
27/11/2020,十一,屯門客運碼頭,出境,0,0,0,0
28/11/2020,十一,機場,入境,1039,9,15,1063
28/11/2020,十一,機場,出境,971,15,46,1032
28/11/2020,十一,高鐵西九龍,入境,0,0,0,0
28/11/2020,十一,高鐵西九龍,出境,0,0,0,0
28/11/2020,十一,紅磡,入境,0,0,0,0
28/11/2020,十一,紅磡,出境,0,0,0,0
28/11/2020,十一,羅湖,入境,0,0,0,0
28/11/2020,十一,羅湖,出境,0,0,0,0
28/11/2020,十一,落馬洲支線,入境,0,0,0,0
28/11/2020,十一,落馬洲支線,出境,0,0,0,0
28/11/2020,十一,香園圍,入境,0,0,0,0
28/11/2020,十一,香園圍,出境,0,0,0,0
28/11/2020,十一,港珠澳大橋,入境,76,2,1,79
28/11/2020,十一,港珠澳大橋,出境,233,9,5,247
28/11/2020,十一,落馬洲,入境,0,0,0,0
28/11/2020,十一,落馬洲,出境,0,0,0,0
28/11/2020,十一,文錦渡,入境,0,0,0,0
28/11/2020,十一,文錦渡,出境,0,0,0,0
28/11/2020,十一,沙頭角,入境,0,0,0,0
28/11/2020,十一,沙頭角,出境,0,0,0,0
28/11/2020,十一,深圳灣,入境,865,75,8,948
28/11/2020,十一,深圳灣,出境,1002,135,3,1140
28/11/2020,十一,中國客運碼頭,入境,0,0,0,0
28/11/2020,十一,中國客運碼頭,出境,0,0,0,0
28/11/2020,十一,港口管制,入境,0,0,0,0
28/11/2020,十一,港口管制,出境,0,0,0,0
28/11/2020,十一,啟德郵輪碼頭,入境,0,0,0,0
28/11/2020,十一,啟德郵輪碼頭,出境,0,0,0,0
28/11/2020,十一,港澳客輪碼頭,入境,0,0,0,0
28/11/2020,十一,港澳客輪碼頭,出境,0,0,0,0
28/11/2020,十一,屯門客運碼頭,入境,0,0,0,0
28/11/2020,十一,屯門客運碼頭,出境,0,0,0,0
29/11/2020,十一,機場,入境,1278,4,33,1315
29/11/2020,十一,機場,出境,1338,15,54,1407
29/11/2020,十一,高鐵西九龍,入境,0,0,0,0
29/11/2020,十一,高鐵西九龍,出境,0,0,0,0
29/11/2020,十一,紅磡,入境,0,0,0,0
29/11/2020,十一,紅磡,出境,0,0,0,0
29/11/2020,十一,羅湖,入境,0,0,0,0
29/11/2020,十一,羅湖,出境,0,0,0,0
29/11/2020,十一,落馬洲支線,入境,0,0,0,0
29/11/2020,十一,落馬洲支線,出境,0,0,0,0
29/11/2020,十一,香園圍,入境,0,0,0,0
29/11/2020,十一,香園圍,出境,0,0,0,0
29/11/2020,十一,港珠澳大橋,入境,125,4,6,135
29/11/2020,十一,港珠澳大橋,出境,141,11,2,154
29/11/2020,十一,落馬洲,入境,0,0,0,0
29/11/2020,十一,落馬洲,出境,0,0,0,0
29/11/2020,十一,文錦渡,入境,0,0,0,0
29/11/2020,十一,文錦渡,出境,0,0,0,0
29/11/2020,十一,沙頭角,入境,0,0,0,0
29/11/2020,十一,沙頭角,出境,0,0,0,0
29/11/2020,十一,深圳灣,入境,1140,88,9,1237
29/11/2020,十一,深圳灣,出境,760,126,5,891
29/11/2020,十一,中國客運碼頭,入境,0,0,0,0
29/11/2020,十一,中國客運碼頭,出境,0,0,0,0
29/11/2020,十一,港口管制,入境,0,0,0,0
29/11/2020,十一,港口管制,出境,0,0,0,0
29/11/2020,十一,啟德郵輪碼頭,入境,0,0,0,0
29/11/2020,十一,啟德郵輪碼頭,出境,0,0,0,0
29/11/2020,十一,港澳客輪碼頭,入境,0,0,0,0
29/11/2020,十一,港澳客輪碼頭,出境,0,0,0,0
29/11/2020,十一,屯門客運碼頭,入境,0,0,0,0
29/11/2020,十一,屯門客運碼頭,出境,0,0,0,0
30/11/2020,十一,機場,入境,787,0,22,809
30/11/2020,十一,機場,出境,679,1,56,736
30/11/2020,十一,高鐵西九龍,入境,0,0,0,0
30/11/2020,十一,高鐵西九龍,出境,0,0,0,0
30/11/2020,十一,紅磡,入境,0,0,0,0
30/11/2020,十一,紅磡,出境,0,0,0,0
30/11/2020,十一,羅湖,入境,0,0,0,0
30/11/2020,十一,羅湖,出境,0,0,0,0
30/11/2020,十一,落馬洲支線,入境,0,0,0,0
30/11/2020,十一,落馬洲支線,出境,0,0,0,0
30/11/2020,十一,香園圍,入境,0,0,0,0
30/11/2020,十一,香園圍,出境,0,0,0,0
30/11/2020,十一,港珠澳大橋,入境,158,4,2,164
30/11/2020,十一,港珠澳大橋,出境,177,10,0,187
30/11/2020,十一,落馬洲,入境,0,0,0,0
30/11/2020,十一,落馬洲,出境,0,0,0,0
30/11/2020,十一,文錦渡,入境,0,0,0,0
30/11/2020,十一,文錦渡,出境,0,0,0,0
30/11/2020,十一,沙頭角,入境,0,0,0,0
30/11/2020,十一,沙頭角,出境,0,0,0,0
30/11/2020,十一,深圳灣,入境,1190,69,1,1260
30/11/2020,十一,深圳灣,出境,914,94,2,1010
30/11/2020,十一,中國客運碼頭,入境,0,0,0,0
30/11/2020,十一,中國客運碼頭,出境,0,0,0,0
30/11/2020,十一,港口管制,入境,0,0,0,0
30/11/2020,十一,港口管制,出境,0,0,0,0
30/11/2020,十一,啟德郵輪碼頭,入境,0,0,0,0
30/11/2020,十一,啟德郵輪碼頭,出境,0,0,0,0
30/11/2020,十一,港澳客輪碼頭,入境,0,0,0,0
30/11/2020,十一,港澳客輪碼頭,出境,0,0,0,0
30/11/2020,十一,屯門客運碼頭,入境,0,0,0,0
30/11/2020,十一,屯門客運碼頭,出境,0,0,0,0
1/12/2020,十一,機場,入境,746,4,21,771
1/12/2020,十一,機場,出境,1344,23,30,1397
1/12/2020,十一,高鐵西九龍,入境,0,0,0,0
1/12/2020,十一,高鐵西九龍,出境,0,0,0,0
1/12/2020,十一,紅磡,入境,0,0,0,0
1/12/2020,十一,紅磡,出境,0,0,0,0
1/12/2020,十一,羅湖,入境,0,0,0,0
1/12/2020,十一,羅湖,出境,0,0,0,0
1/12/2020,十一,落馬洲支線,入境,0,0,0,0
1/12/2020,十一,落馬洲支線,出境,0,0,0,0
1/12/2020,十一,香園圍,入境,0,0,0,0
1/12/2020,十一,香園圍,出境,0,0,0,0
1/12/2020,十一,港珠澳大橋,入境,80,3,3,86
1/12/2020,十一,港珠澳大橋,出境,279,15,9,303
1/12/2020,十一,落馬洲,入境,0,0,0,0
1/12/2020,十一,落馬洲,出境,0,0,0,0
1/12/2020,十一,文錦渡,入境,0,0,0,0
1/12/2020,十一,文錦渡,出境,0,0,0,0
1/12/2020,十一,沙頭角,入境,0,0,0,0
1/12/2020,十一,沙頭角,出境,0,0,0,0
1/12/2020,十一,深圳灣,入境,742,57,2,801
1/12/2020,十一,深圳灣,出境,2704,357,6,3067
1/12/2020,十一,中國客運碼頭,入境,0,0,0,0
1/12/2020,十一,中國客運碼頭,出境,0,0,0,0
1/12/2020,十一,港口管制,入境,0,0,0,0
1/12/2020,十一,港口管制,出境,0,0,0,0
1/12/2020,十一,啟德郵輪碼頭,入境,0,0,0,0
1/12/2020,十一,啟德郵輪碼頭,出境,0,0,0,0
1/12/2020,十一,港澳客輪碼頭,入境,0,0,0,0
1/12/2020,十一,港澳客輪碼頭,出境,0,0,0,0
1/12/2020,十一,屯門客運碼頭,入境,0,0,0,0
1/12/2020,十一,屯門客運碼頭,出境,0,0,0,0
2/12/2020,十一,機場,入境,587,1,28,616
2/12/2020,十一,機場,出境,918,18,55,991
2/12/2020,十一,高鐵西九龍,入境,0,0,0,0
2/12/2020,十一,高鐵西九龍,出境,0,0,0,0
2/12/2020,十一,紅磡,入境,0,0,0,0
2/12/2020,十一,紅磡,出境,0,0,0,0
2/12/2020,十一,羅湖,入境,0,0,0,0
2/12/2020,十一,羅湖,出境,0,0,0,0
2/12/2020,十一,落馬洲支線,入境,0,0,0,0
2/12/2020,十一,落馬洲支線,出境,0,0,0,0
2/12/2020,十一,香園圍,入境,0,0,0,0
2/12/2020,十一,香園圍,出境,0,0,0,0
2/12/2020,十一,港珠澳大橋,入境,84,2,23,109
2/12/2020,十一,港珠澳大橋,出境,280,18,8,306
2/12/2020,十一,落馬洲,入境,0,0,0,0
2/12/2020,十一,落馬洲,出境,0,0,0,0
2/12/2020,十一,文錦渡,入境,0,0,0,0
2/12/2020,十一,文錦渡,出境,0,0,0,0
2/12/2020,十一,沙頭角,入境,0,0,0,0
2/12/2020,十一,沙頭角,出境,0,0,0,0
2/12/2020,十一,深圳灣,入境,676,63,2,741
2/12/2020,十一,深圳灣,出境,3060,436,13,3509
2/12/2020,十一,中國客運碼頭,入境,0,0,0,0
2/12/2020,十一,中國客運碼頭,出境,0,0,0,0
2/12/2020,十一,港口管制,入境,0,0,0,0
2/12/2020,十一,港口管制,出境,0,0,0,0
2/12/2020,十一,啟德郵輪碼頭,入境,0,0,0,0
2/12/2020,十一,啟德郵輪碼頭,出境,0,0,0,0
2/12/2020,十一,港澳客輪碼頭,入境,0,0,0,0
2/12/2020,十一,港澳客輪碼頭,出境,0,0,0,0
2/12/2020,十一,屯門客運碼頭,入境,0,0,0,0
2/12/2020,十一,屯門客運碼頭,出境,0,0,0,0
3/12/2020,十一,機場,入境,841,2,38,881
3/12/2020,十一,機場,出境,919,4,34,957
3/12/2020,十一,高鐵西九龍,入境,0,0,0,0
3/12/2020,十一,高鐵西九龍,出境,0,0,0,0
3/12/2020,十一,紅磡,入境,0,0,0,0
3/12/2020,十一,紅磡,出境,0,0,0,0
3/12/2020,十一,羅湖,入境,0,0,0,0
3/12/2020,十一,羅湖,出境,0,0,0,0
3/12/2020,十一,落馬洲支線,入境,0,0,0,0
3/12/2020,十一,落馬洲支線,出境,0,0,0,0
3/12/2020,十一,香園圍,入境,0,0,0,0
3/12/2020,十一,香園圍,出境,0,0,0,0
3/12/2020,十一,港珠澳大橋,入境,71,4,2,77
3/12/2020,十一,港珠澳大橋,出境,271,12,11,294
3/12/2020,十一,落馬洲,入境,0,0,0,0
3/12/2020,十一,落馬洲,出境,0,0,0,0
3/12/2020,十一,文錦渡,入境,0,0,0,0
3/12/2020,十一,文錦渡,出境,0,0,0,0
3/12/2020,十一,沙頭角,入境,0,0,0,0
3/12/2020,十一,沙頭角,出境,0,0,0,0
3/12/2020,十一,深圳灣,入境,688,56,2,746
3/12/2020,十一,深圳灣,出境,2948,410,10,3368
3/12/2020,十一,中國客運碼頭,入境,0,0,0,0
3/12/2020,十一,中國客運碼頭,出境,0,0,0,0
3/12/2020,十一,港口管制,入境,0,0,0,0
3/12/2020,十一,港口管制,出境,0,0,0,0
3/12/2020,十一,啟德郵輪碼頭,入境,0,0,0,0
3/12/2020,十一,啟德郵輪碼頭,出境,0,0,0,0
3/12/2020,十一,港澳客輪碼頭,入境,0,0,0,0
3/12/2020,十一,港澳客輪碼頭,出境,0,0,0,0
3/12/2020,十一,屯門客運碼頭,入境,0,0,0,0
3/12/2020,十一,屯門客運碼頭,出境,0,0,0,0
4/12/2020,十一,機場,入境,1258,7,34,1299
4/12/2020,十一,機場,出境,1423,23,40,1486
4/12/2020,十一,高鐵西九龍,入境,0,0,0,0
4/12/2020,十一,高鐵西九龍,出境,0,0,0,0
4/12/2020,十一,紅磡,入境,0,0,0,0
4/12/2020,十一,紅磡,出境,0,0,0,0
4/12/2020,十一,羅湖,入境,0,0,0,0
4/12/2020,十一,羅湖,出境,0,0,0,0
4/12/2020,十一,落馬洲支線,入境,0,0,0,0
4/12/2020,十一,落馬洲支線,出境,0,0,0,0
4/12/2020,十一,香園圍,入境,0,0,0,0
4/12/2020,十一,香園圍,出境,0,0,0,0
4/12/2020,十一,港珠澳大橋,入境,97,8,7,112
4/12/2020,十一,港珠澳大橋,出境,275,16,4,295
4/12/2020,十一,落馬洲,入境,0,0,0,0
4/12/2020,十一,落馬洲,出境,0,0,0,0
4/12/2020,十一,文錦渡,入境,0,0,0,0
4/12/2020,十一,文錦渡,出境,0,0,0,0
4/12/2020,十一,沙頭角,入境,0,0,0,0
4/12/2020,十一,沙頭角,出境,0,0,0,0
4/12/2020,十一,深圳灣,入境,518,52,4,574
4/12/2020,十一,深圳灣,出境,2790,371,5,3166
4/12/2020,十一,中國客運碼頭,入境,0,0,0,0
4/12/2020,十一,中國客運碼頭,出境,0,0,0,0
4/12/2020,十一,港口管制,入境,0,0,0,0
4/12/2020,十一,港口管制,出境,0,0,0,0
4/12/2020,十一,啟德郵輪碼頭,入境,0,0,0,0
4/12/2020,十一,啟德郵輪碼頭,出境,0,0,0,0
4/12/2020,十一,港澳客輪碼頭,入境,0,0,0,0
4/12/2020,十一,港澳客輪碼頭,出境,0,0,0,0
4/12/2020,十一,屯門客運碼頭,入境,0,0,0,0
4/12/2020,十一,屯門客運碼頭,出境,0,0,0,0
5/12/2020,十一,機場,入境,922,0,18,940
5/12/2020,十一,機場,出境,1559,30,39,1628
5/12/2020,十一,高鐵西九龍,入境,0,0,0,0
5/12/2020,十一,高鐵西九龍,出境,0,0,0,0
5/12/2020,十一,紅磡,入境,0,0,0,0
5/12/2020,十一,紅磡,出境,0,0,0,0
5/12/2020,十一,羅湖,入境,0,0,0,0
5/12/2020,十一,羅湖,出境,0,0,0,0
5/12/2020,十一,落馬洲支線,入境,0,0,0,0
5/12/2020,十一,落馬洲支線,出境,0,0,0,0
5/12/2020,十一,香園圍,入境,0,0,0,0
5/12/2020,十一,香園圍,出境,0,0,0,0
5/12/2020,十一,港珠澳大橋,入境,63,3,2,68
5/12/2020,十一,港珠澳大橋,出境,297,12,7,316
5/12/2020,十一,落馬洲,入境,0,0,0,0
5/12/2020,十一,落馬洲,出境,0,0,0,0
5/12/2020,十一,文錦渡,入境,0,0,0,0
5/12/2020,十一,文錦渡,出境,0,0,0,0
5/12/2020,十一,沙頭角,入境,0,0,0,0
5/12/2020,十一,沙頭角,出境,0,0,0,0
5/12/2020,十一,深圳灣,入境,623,80,4,707
5/12/2020,十一,深圳灣,出境,2554,314,6,2874
5/12/2020,十一,中國客運碼頭,入境,0,0,0,0
5/12/2020,十一,中國客運碼頭,出境,0,0,0,0
5/12/2020,十一,港口管制,入境,0,0,0,0
5/12/2020,十一,港口管制,出境,0,0,0,0
5/12/2020,十一,啟德郵輪碼頭,入境,0,0,0,0
5/12/2020,十一,啟德郵輪碼頭,出境,0,0,0,0
5/12/2020,十一,港澳客輪碼頭,入境,0,0,0,0
5/12/2020,十一,港澳客輪碼頭,出境,0,0,0,0
5/12/2020,十一,屯門客運碼頭,入境,0,0,0,0
5/12/2020,十一,屯門客運碼頭,出境,0,0,0,0
6/12/2020,十一,機場,入境,1837,6,40,1883
6/12/2020,十一,機場,出境,1407,24,55,1486
6/12/2020,十一,高鐵西九龍,入境,0,0,0,0
6/12/2020,十一,高鐵西九龍,出境,0,0,0,0
6/12/2020,十一,紅磡,入境,0,0,0,0
6/12/2020,十一,紅磡,出境,0,0,0,0
6/12/2020,十一,羅湖,入境,0,0,0,0
6/12/2020,十一,羅湖,出境,0,0,0,0
6/12/2020,十一,落馬洲支線,入境,0,0,0,0
6/12/2020,十一,落馬洲支線,出境,0,0,0,0
6/12/2020,十一,香園圍,入境,0,0,0,0
6/12/2020,十一,香園圍,出境,0,0,0,0
6/12/2020,十一,港珠澳大橋,入境,68,2,2,72
6/12/2020,十一,港珠澳大橋,出境,258,17,3,278
6/12/2020,十一,落馬洲,入境,0,0,0,0
6/12/2020,十一,落馬洲,出境,0,0,0,0
6/12/2020,十一,文錦渡,入境,0,0,0,0
6/12/2020,十一,文錦渡,出境,0,0,0,0
6/12/2020,十一,沙頭角,入境,0,0,0,0
6/12/2020,十一,沙頭角,出境,0,0,0,0
6/12/2020,十一,深圳灣,入境,616,79,2,697
6/12/2020,十一,深圳灣,出境,1761,205,0,1966
6/12/2020,十一,中國客運碼頭,入境,0,0,0,0
6/12/2020,十一,中國客運碼頭,出境,0,0,0,0
6/12/2020,十一,港口管制,入境,0,0,0,0
6/12/2020,十一,港口管制,出境,0,0,0,0
6/12/2020,十一,啟德郵輪碼頭,入境,0,0,0,0
6/12/2020,十一,啟德郵輪碼頭,出境,0,0,0,0
6/12/2020,十一,港澳客輪碼頭,入境,0,0,0,0
6/12/2020,十一,港澳客輪碼頭,出境,0,0,0,0
6/12/2020,十一,屯門客運碼頭,入境,0,0,0,0
6/12/2020,十一,屯門客運碼頭,出境,0,0,0,0
7/12/2020,十一,機場,入境,1470,2,64,1536
7/12/2020,十一,機場,出境,839,9,30,878
7/12/2020,十一,高鐵西九龍,入境,0,0,0,0
7/12/2020,十一,高鐵西九龍,出境,0,0,0,0
7/12/2020,十一,紅磡,入境,0,0,0,0
7/12/2020,十一,紅磡,出境,0,0,0,0
7/12/2020,十一,羅湖,入境,0,0,0,0
7/12/2020,十一,羅湖,出境,0,0,0,0
7/12/2020,十一,落馬洲支線,入境,0,0,0,0
7/12/2020,十一,落馬洲支線,出境,0,0,0,0
7/12/2020,十一,香園圍,入境,0,0,0,0
7/12/2020,十一,香園圍,出境,0,0,0,0
7/12/2020,十一,港珠澳大橋,入境,157,8,9,174
7/12/2020,十一,港珠澳大橋,出境,255,16,4,275
7/12/2020,十一,落馬洲,入境,0,0,0,0
7/12/2020,十一,落馬洲,出境,0,0,0,0
7/12/2020,十一,文錦渡,入境,0,0,0,0
7/12/2020,十一,文錦渡,出境,0,0,0,0
7/12/2020,十一,沙頭角,入境,0,0,0,0
7/12/2020,十一,沙頭角,出境,0,0,0,0
7/12/2020,十一,深圳灣,入境,1023,63,2,1088
7/12/2020,十一,深圳灣,出境,1354,133,3,1490
7/12/2020,十一,中國客運碼頭,入境,0,0,0,0
7/12/2020,十一,中國客運碼頭,出境,0,0,0,0
7/12/2020,十一,港口管制,入境,0,0,0,0
7/12/2020,十一,港口管制,出境,0,0,0,0
7/12/2020,十一,啟德郵輪碼頭,入境,0,0,0,0
7/12/2020,十一,啟德郵輪碼頭,出境,0,0,0,0
7/12/2020,十一,港澳客輪碼頭,入境,0,0,0,0
7/12/2020,十一,港澳客輪碼頭,出境,0,0,0,0
7/12/2020,十一,屯門客運碼頭,入境,0,0,0,0
7/12/2020,十一,屯門客運碼頭,出境,0,0,0,0
8/12/2020,十一,機場,入境,823,4,20,847
8/12/2020,十一,機場,出境,1444,30,45,1519
8/12/2020,十一,高鐵西九龍,入境,0,0,0,0
8/12/2020,十一,高鐵西九龍,出境,0,0,0,0
8/12/2020,十一,紅磡,入境,0,0,0,0
8/12/2020,十一,紅磡,出境,0,0,0,0
8/12/2020,十一,羅湖,入境,0,0,0,0
8/12/2020,十一,羅湖,出境,0,0,0,0
8/12/2020,十一,落馬洲支線,入境,0,0,0,0
8/12/2020,十一,落馬洲支線,出境,0,0,0,0
8/12/2020,十一,香園圍,入境,0,0,0,0
8/12/2020,十一,香園圍,出境,0,0,0,0
8/12/2020,十一,港珠澳大橋,入境,73,2,6,81
8/12/2020,十一,港珠澳大橋,出境,299,8,1,308
8/12/2020,十一,落馬洲,入境,0,0,0,0
8/12/2020,十一,落馬洲,出境,0,0,0,0
8/12/2020,十一,文錦渡,入境,0,0,0,0
8/12/2020,十一,文錦渡,出境,0,0,0,0
8/12/2020,十一,沙頭角,入境,0,0,0,0
8/12/2020,十一,沙頭角,出境,0,0,0,0
8/12/2020,十一,深圳灣,入境,708,64,4,776
8/12/2020,十一,深圳灣,出境,1834,197,7,2038
8/12/2020,十一,中國客運碼頭,入境,0,0,0,0
8/12/2020,十一,中國客運碼頭,出境,0,0,0,0
8/12/2020,十一,港口管制,入境,0,0,0,0
8/12/2020,十一,港口管制,出境,0,0,0,0
8/12/2020,十一,啟德郵輪碼頭,入境,0,0,0,0
8/12/2020,十一,啟德郵輪碼頭,出境,0,0,0,0
8/12/2020,十一,港澳客輪碼頭,入境,0,0,0,0
8/12/2020,十一,港澳客輪碼頭,出境,0,0,0,0
8/12/2020,十一,屯門客運碼頭,入境,0,0,0,0
8/12/2020,十一,屯門客運碼頭,出境,0,0,0,0
9/12/2020,十一,機場,入境,899,1,43,943
9/12/2020,十一,機場,出境,1108,10,73,1191
9/12/2020,十一,高鐵西九龍,入境,0,0,0,0
9/12/2020,十一,高鐵西九龍,出境,0,0,0,0
9/12/2020,十一,紅磡,入境,0,0,0,0
9/12/2020,十一,紅磡,出境,0,0,0,0
9/12/2020,十一,羅湖,入境,0,0,0,0
9/12/2020,十一,羅湖,出境,0,0,0,0
9/12/2020,十一,落馬洲支線,入境,0,0,0,0
9/12/2020,十一,落馬洲支線,出境,0,0,0,0
9/12/2020,十一,香園圍,入境,0,0,0,0
9/12/2020,十一,香園圍,出境,0,0,0,0
9/12/2020,十一,港珠澳大橋,入境,72,1,7,80
9/12/2020,十一,港珠澳大橋,出境,310,14,3,327
9/12/2020,十一,落馬洲,入境,0,0,0,0
9/12/2020,十一,落馬洲,出境,0,0,0,0
9/12/2020,十一,文錦渡,入境,0,0,0,0
9/12/2020,十一,文錦渡,出境,0,0,0,0
9/12/2020,十一,沙頭角,入境,0,0,0,0
9/12/2020,十一,沙頭角,出境,0,0,0,0
9/12/2020,十一,深圳灣,入境,610,58,3,671
9/12/2020,十一,深圳灣,出境,1865,182,1,2048
9/12/2020,十一,中國客運碼頭,入境,0,0,0,0
9/12/2020,十一,中國客運碼頭,出境,0,0,0,0
9/12/2020,十一,港口管制,入境,0,0,0,0
9/12/2020,十一,港口管制,出境,0,0,0,0
9/12/2020,十一,啟德郵輪碼頭,入境,0,0,0,0
9/12/2020,十一,啟德郵輪碼頭,出境,0,0,0,0
9/12/2020,十一,港澳客輪碼頭,入境,0,0,0,0
9/12/2020,十一,港澳客輪碼頭,出境,0,0,0,0
9/12/2020,十一,屯門客運碼頭,入境,0,0,0,0
9/12/2020,十一,屯門客運碼頭,出境,0,0,0,0
10/12/2020,十一,機場,入境,793,3,39,835
10/12/2020,十一,機場,出境,1307,10,142,1459
10/12/2020,十一,高鐵西九龍,入境,0,0,0,0
10/12/2020,十一,高鐵西九龍,出境,0,0,0,0
10/12/2020,十一,紅磡,入境,0,0,0,0
10/12/2020,十一,紅磡,出境,0,0,0,0
10/12/2020,十一,羅湖,入境,0,0,0,0
10/12/2020,十一,羅湖,出境,0,0,0,0
10/12/2020,十一,落馬洲支線,入境,0,0,0,0
10/12/2020,十一,落馬洲支線,出境,0,0,0,0
10/12/2020,十一,香園圍,入境,0,0,0,0
10/12/2020,十一,香園圍,出境,0,0,0,0
10/12/2020,十一,港珠澳大橋,入境,74,2,87,163
10/12/2020,十一,港珠澳大橋,出境,294,9,6,309
10/12/2020,十一,落馬洲,入境,0,0,0,0
10/12/2020,十一,落馬洲,出境,0,0,0,0
10/12/2020,十一,文錦渡,入境,0,0,0,0
10/12/2020,十一,文錦渡,出境,0,0,0,0
10/12/2020,十一,沙頭角,入境,0,0,0,0
10/12/2020,十一,沙頭角,出境,0,0,0,0
10/12/2020,十一,深圳灣,入境,606,69,3,678
10/12/2020,十一,深圳灣,出境,1978,220,2,2200
10/12/2020,十一,中國客運碼頭,入境,0,0,0,0
10/12/2020,十一,中國客運碼頭,出境,0,0,0,0
10/12/2020,十一,港口管制,入境,0,0,0,0
10/12/2020,十一,港口管制,出境,0,0,0,0
10/12/2020,十一,啟德郵輪碼頭,入境,0,0,0,0
10/12/2020,十一,啟德郵輪碼頭,出境,0,0,0,0
10/12/2020,十一,港澳客輪碼頭,入境,0,0,0,0
10/12/2020,十一,港澳客輪碼頭,出境,0,0,0,0
10/12/2020,十一,屯門客運碼頭,入境,0,0,0,0
10/12/2020,十一,屯門客運碼頭,出境,0,0,0,0
11/12/2020,十一,機場,入境,1050,2,57,1109
11/12/2020,十一,機場,出境,1514,22,45,1581
11/12/2020,十一,高鐵西九龍,入境,0,0,0,0
11/12/2020,十一,高鐵西九龍,出境,0,0,0,0
11/12/2020,十一,紅磡,入境,0,0,0,0
11/12/2020,十一,紅磡,出境,0,0,0,0
11/12/2020,十一,羅湖,入境,0,0,0,0
11/12/2020,十一,羅湖,出境,0,0,0,0
11/12/2020,十一,落馬洲支線,入境,0,0,0,0
11/12/2020,十一,落馬洲支線,出境,0,0,0,0
11/12/2020,十一,香園圍,入境,0,0,0,0
11/12/2020,十一,香園圍,出境,0,0,0,0
11/12/2020,十一,港珠澳大橋,入境,105,3,7,115
11/12/2020,十一,港珠澳大橋,出境,262,9,4,275
11/12/2020,十一,落馬洲,入境,0,0,0,0
11/12/2020,十一,落馬洲,出境,0,0,0,0
11/12/2020,十一,文錦渡,入境,0,0,0,0
11/12/2020,十一,文錦渡,出境,0,0,0,0
11/12/2020,十一,沙頭角,入境,0,0,0,0
11/12/2020,十一,沙頭角,出境,0,0,0,0
11/12/2020,十一,深圳灣,入境,524,52,3,579
11/12/2020,十一,深圳灣,出境,2134,228,5,2367
11/12/2020,十一,中國客運碼頭,入境,0,0,0,0
11/12/2020,十一,中國客運碼頭,出境,0,0,0,0
11/12/2020,十一,港口管制,入境,0,0,0,0
11/12/2020,十一,港口管制,出境,0,0,0,0
11/12/2020,十一,啟德郵輪碼頭,入境,0,0,0,0
11/12/2020,十一,啟德郵輪碼頭,出境,0,0,0,0
11/12/2020,十一,港澳客輪碼頭,入境,0,0,0,0
11/12/2020,十一,港澳客輪碼頭,出境,0,0,0,0
11/12/2020,十一,屯門客運碼頭,入境,0,0,0,0
11/12/2020,十一,屯門客運碼頭,出境,0,0,0,0
12/12/2020,十一,機場,入境,543,4,13,560
12/12/2020,十一,機場,出境,1558,17,27,1602
12/12/2020,十一,高鐵西九龍,入境,0,0,0,0
12/12/2020,十一,高鐵西九龍,出境,0,0,0,0
12/12/2020,十一,紅磡,入境,0,0,0,0
12/12/2020,十一,紅磡,出境,0,0,0,0
12/12/2020,十一,羅湖,入境,0,0,0,0
12/12/2020,十一,羅湖,出境,0,0,0,0
12/12/2020,十一,落馬洲支線,入境,0,0,0,0
12/12/2020,十一,落馬洲支線,出境,0,0,0,0
12/12/2020,十一,香園圍,入境,0,0,0,0
12/12/2020,十一,香園圍,出境,0,0,0,0
12/12/2020,十一,港珠澳大橋,入境,61,3,5,69
12/12/2020,十一,港珠澳大橋,出境,267,14,5,286
12/12/2020,十一,落馬洲,入境,0,0,0,0
12/12/2020,十一,落馬洲,出境,0,0,0,0
12/12/2020,十一,文錦渡,入境,0,0,0,0
12/12/2020,十一,文錦渡,出境,0,0,0,0
12/12/2020,十一,沙頭角,入境,0,0,0,0
12/12/2020,十一,沙頭角,出境,0,0,0,0
12/12/2020,十一,深圳灣,入境,494,63,5,562
12/12/2020,十一,深圳灣,出境,1994,219,3,2216
12/12/2020,十一,中國客運碼頭,入境,0,0,0,0
12/12/2020,十一,中國客運碼頭,出境,0,0,0,0
12/12/2020,十一,港口管制,入境,0,0,0,0
12/12/2020,十一,港口管制,出境,0,0,0,0
12/12/2020,十一,啟德郵輪碼頭,入境,0,0,0,0
12/12/2020,十一,啟德郵輪碼頭,出境,0,0,0,0
12/12/2020,十一,港澳客輪碼頭,入境,0,0,0,0
12/12/2020,十一,港澳客輪碼頭,出境,0,0,0,0
12/12/2020,十一,屯門客運碼頭,入境,0,0,0,0
12/12/2020,十一,屯門客運碼頭,出境,0,0,0,0
13/12/2020,十一,機場,入境,1012,2,37,1051
13/12/2020,十一,機場,出境,1490,28,50,1568
13/12/2020,十一,高鐵西九龍,入境,0,0,0,0
13/12/2020,十一,高鐵西九龍,出境,0,0,0,0
13/12/2020,十一,紅磡,入境,0,0,0,0
13/12/2020,十一,紅磡,出境,0,0,0,0
13/12/2020,十一,羅湖,入境,0,0,0,0
13/12/2020,十一,羅湖,出境,0,0,0,0
13/12/2020,十一,落馬洲支線,入境,0,0,0,0
13/12/2020,十一,落馬洲支線,出境,0,0,0,0
13/12/2020,十一,香園圍,入境,0,0,0,0
13/12/2020,十一,香園圍,出境,0,0,0,0
13/12/2020,十一,港珠澳大橋,入境,33,3,4,40
13/12/2020,十一,港珠澳大橋,出境,304,18,5,327
13/12/2020,十一,落馬洲,入境,0,0,0,0
13/12/2020,十一,落馬洲,出境,0,0,0,0
13/12/2020,十一,文錦渡,入境,0,0,0,0
13/12/2020,十一,文錦渡,出境,0,0,0,0
13/12/2020,十一,沙頭角,入境,0,0,0,0
13/12/2020,十一,沙頭角,出境,0,0,0,0
13/12/2020,十一,深圳灣,入境,513,58,1,572
13/12/2020,十一,深圳灣,出境,1426,167,1,1594
13/12/2020,十一,中國客運碼頭,入境,0,0,0,0
13/12/2020,十一,中國客運碼頭,出境,0,0,0,0
13/12/2020,十一,港口管制,入境,0,0,0,0
13/12/2020,十一,港口管制,出境,0,0,0,0
13/12/2020,十一,啟德郵輪碼頭,入境,0,0,0,0
13/12/2020,十一,啟德郵輪碼頭,出境,0,0,0,0
13/12/2020,十一,港澳客輪碼頭,入境,0,0,0,0
13/12/2020,十一,港澳客輪碼頭,出境,0,0,0,0
13/12/2020,十一,屯門客運碼頭,入境,0,0,0,0
13/12/2020,十一,屯門客運碼頭,出境,0,0,0,0
14/12/2020,十一,機場,入境,318,4,21,343
14/12/2020,十一,機場,出境,873,15,67,955
14/12/2020,十一,高鐵西九龍,入境,0,0,0,0
14/12/2020,十一,高鐵西九龍,出境,0,0,0,0
14/12/2020,十一,紅磡,入境,0,0,0,0
14/12/2020,十一,紅磡,出境,0,0,0,0
14/12/2020,十一,羅湖,入境,0,0,0,0
14/12/2020,十一,羅湖,出境,0,0,0,0
14/12/2020,十一,落馬洲支線,入境,0,0,0,0
14/12/2020,十一,落馬洲支線,出境,0,0,0,0
14/12/2020,十一,香園圍,入境,0,0,0,0
14/12/2020,十一,香園圍,出境,0,0,0,0
14/12/2020,十一,港珠澳大橋,入境,151,9,5,165
14/12/2020,十一,港珠澳大橋,出境,224,15,1,240
14/12/2020,十一,落馬洲,入境,0,0,0,0
14/12/2020,十一,落馬洲,出境,0,0,0,0
14/12/2020,十一,文錦渡,入境,0,0,0,0
14/12/2020,十一,文錦渡,出境,0,0,0,0
14/12/2020,十一,沙頭角,入境,0,0,0,0
14/12/2020,十一,沙頭角,出境,0,0,0,0
14/12/2020,十一,深圳灣,入境,984,60,1,1045
14/12/2020,十一,深圳灣,出境,1315,129,2,1446
14/12/2020,十一,中國客運碼頭,入境,0,0,0,0
14/12/2020,十一,中國客運碼頭,出境,0,0,0,0
14/12/2020,十一,港口管制,入境,0,0,0,0
14/12/2020,十一,港口管制,出境,0,0,0,0
14/12/2020,十一,啟德郵輪碼頭,入境,0,0,0,0
14/12/2020,十一,啟德郵輪碼頭,出境,0,0,0,0
14/12/2020,十一,港澳客輪碼頭,入境,0,0,0,0
14/12/2020,十一,港澳客輪碼頭,出境,0,0,0,0
14/12/2020,十一,屯門客運碼頭,入境,0,0,0,0
14/12/2020,十一,屯門客運碼頭,出境,0,0,0,0
15/12/2020,十一,機場,入境,531,10,28,569
15/12/2020,十一,機場,出境,1440,38,41,1519
15/12/2020,十一,高鐵西九龍,入境,0,0,0,0
15/12/2020,十一,高鐵西九龍,出境,0,0,0,0
15/12/2020,十一,紅磡,入境,0,0,0,0
15/12/2020,十一,紅磡,出境,0,0,0,0
15/12/2020,十一,羅湖,入境,0,0,0,0
15/12/2020,十一,羅湖,出境,0,0,0,0
15/12/2020,十一,落馬洲支線,入境,0,0,0,0
15/12/2020,十一,落馬洲支線,出境,0,0,0,0
15/12/2020,十一,香園圍,入境,0,0,0,0
15/12/2020,十一,香園圍,出境,0,0,0,0
15/12/2020,十一,港珠澳大橋,入境,83,5,5,93
15/12/2020,十一,港珠澳大橋,出境,260,17,6,283
15/12/2020,十一,落馬洲,入境,0,0,0,0
15/12/2020,十一,落馬洲,出境,0,0,0,0
15/12/2020,十一,文錦渡,入境,0,0,0,0
15/12/2020,十一,文錦渡,出境,0,0,0,0
15/12/2020,十一,沙頭角,入境,0,0,0,0
15/12/2020,十一,沙頭角,出境,0,0,0,0
15/12/2020,十一,深圳灣,入境,668,71,1,740
15/12/2020,十一,深圳灣,出境,2015,192,6,2213
15/12/2020,十一,中國客運碼頭,入境,0,0,0,0
15/12/2020,十一,中國客運碼頭,出境,0,0,0,0
15/12/2020,十一,港口管制,入境,0,0,0,0
15/12/2020,十一,港口管制,出境,0,0,0,0
15/12/2020,十一,啟德郵輪碼頭,入境,0,0,0,0
15/12/2020,十一,啟德郵輪碼頭,出境,0,0,0,0
15/12/2020,十一,港澳客輪碼頭,入境,0,0,0,0
15/12/2020,十一,港澳客輪碼頭,出境,0,0,0,0
15/12/2020,十一,屯門客運碼頭,入境,0,0,0,0
15/12/2020,十一,屯門客運碼頭,出境,0,0,0,0
16/12/2020,十一,機場,入境,509,5,24,538
16/12/2020,十一,機場,出境,1131,12,50,1193
16/12/2020,十一,高鐵西九龍,入境,0,0,0,0
16/12/2020,十一,高鐵西九龍,出境,0,0,0,0
16/12/2020,十一,紅磡,入境,0,0,0,0
16/12/2020,十一,紅磡,出境,0,0,0,0
16/12/2020,十一,羅湖,入境,0,0,0,0
16/12/2020,十一,羅湖,出境,0,0,0,0
16/12/2020,十一,落馬洲支線,入境,0,0,0,0
16/12/2020,十一,落馬洲支線,出境,0,0,0,0
16/12/2020,十一,香園圍,入境,0,0,0,0
16/12/2020,十一,香園圍,出境,0,0,0,0
16/12/2020,十一,港珠澳大橋,入境,107,2,17,126
16/12/2020,十一,港珠澳大橋,出境,246,14,2,262
16/12/2020,十一,落馬洲,入境,0,0,0,0
16/12/2020,十一,落馬洲,出境,0,0,0,0
16/12/2020,十一,文錦渡,入境,0,0,0,0
16/12/2020,十一,文錦渡,出境,0,0,0,0
16/12/2020,十一,沙頭角,入境,0,0,0,0
16/12/2020,十一,沙頭角,出境,0,0,0,0
16/12/2020,十一,深圳灣,入境,693,60,1,754
16/12/2020,十一,深圳灣,出境,2042,222,3,2267
16/12/2020,十一,中國客運碼頭,入境,0,0,0,0
16/12/2020,十一,中國客運碼頭,出境,0,0,0,0
16/12/2020,十一,港口管制,入境,0,0,0,0
16/12/2020,十一,港口管制,出境,0,0,0,0
16/12/2020,十一,啟德郵輪碼頭,入境,0,0,0,0
16/12/2020,十一,啟德郵輪碼頭,出境,0,0,0,0
16/12/2020,十一,港澳客輪碼頭,入境,0,0,0,0
16/12/2020,十一,港澳客輪碼頭,出境,0,0,0,0
16/12/2020,十一,屯門客運碼頭,入境,0,0,0,0
16/12/2020,十一,屯門客運碼頭,出境,0,0,0,0
17/12/2020,十一,機場,入境,622,1,31,654
17/12/2020,十一,機場,出境,1224,10,58,1292
17/12/2020,十一,高鐵西九龍,入境,0,0,0,0
17/12/2020,十一,高鐵西九龍,出境,0,0,0,0
17/12/2020,十一,紅磡,入境,0,0,0,0
17/12/2020,十一,紅磡,出境,0,0,0,0
17/12/2020,十一,羅湖,入境,0,0,0,0
17/12/2020,十一,羅湖,出境,0,0,0,0
17/12/2020,十一,落馬洲支線,入境,0,0,0,0
17/12/2020,十一,落馬洲支線,出境,0,0,0,0
17/12/2020,十一,香園圍,入境,0,0,0,0
17/12/2020,十一,香園圍,出境,0,0,0,0
17/12/2020,十一,港珠澳大橋,入境,122,2,4,128
17/12/2020,十一,港珠澳大橋,出境,257,16,0,273
17/12/2020,十一,落馬洲,入境,0,0,0,0
17/12/2020,十一,落馬洲,出境,0,0,0,0
17/12/2020,十一,文錦渡,入境,0,0,0,0
17/12/2020,十一,文錦渡,出境,0,0,0,0
17/12/2020,十一,沙頭角,入境,0,0,0,0
17/12/2020,十一,沙頭角,出境,0,0,0,0
17/12/2020,十一,深圳灣,入境,535,48,1,584
17/12/2020,十一,深圳灣,出境,1687,190,1,1878
17/12/2020,十一,中國客運碼頭,入境,0,0,0,0
17/12/2020,十一,中國客運碼頭,出境,0,0,0,0
17/12/2020,十一,港口管制,入境,0,0,0,0
17/12/2020,十一,港口管制,出境,0,0,0,0
17/12/2020,十一,啟德郵輪碼頭,入境,0,0,0,0
17/12/2020,十一,啟德郵輪碼頭,出境,0,0,0,0
17/12/2020,十一,港澳客輪碼頭,入境,0,0,0,0
17/12/2020,十一,港澳客輪碼頭,出境,0,0,0,0
17/12/2020,十一,屯門客運碼頭,入境,0,0,0,0
17/12/2020,十一,屯門客運碼頭,出境,0,0,0,0
18/12/2020,十一,機場,入境,775,7,27,809
18/12/2020,十一,機場,出境,1514,25,50,1589
18/12/2020,十一,高鐵西九龍,入境,0,0,0,0
18/12/2020,十一,高鐵西九龍,出境,0,0,0,0
18/12/2020,十一,紅磡,入境,0,0,0,0
18/12/2020,十一,紅磡,出境,0,0,0,0
18/12/2020,十一,羅湖,入境,0,0,0,0
18/12/2020,十一,羅湖,出境,0,0,0,0
18/12/2020,十一,落馬洲支線,入境,0,0,0,0
18/12/2020,十一,落馬洲支線,出境,0,0,0,0
18/12/2020,十一,香園圍,入境,0,0,0,0
18/12/2020,十一,香園圍,出境,0,0,0,0
18/12/2020,十一,港珠澳大橋,入境,191,3,9,203
18/12/2020,十一,港珠澳大橋,出境,259,5,1,265
18/12/2020,十一,落馬洲,入境,0,0,0,0
18/12/2020,十一,落馬洲,出境,0,0,0,0
18/12/2020,十一,文錦渡,入境,0,0,0,0
18/12/2020,十一,文錦渡,出境,0,0,0,0
18/12/2020,十一,沙頭角,入境,0,0,0,0
18/12/2020,十一,沙頭角,出境,0,0,0,0
18/12/2020,十一,深圳灣,入境,886,68,3,957
18/12/2020,十一,深圳灣,出境,1511,173,4,1688
18/12/2020,十一,中國客運碼頭,入境,0,0,0,0
18/12/2020,十一,中國客運碼頭,出境,0,0,0,0
18/12/2020,十一,港口管制,入境,0,0,0,0
18/12/2020,十一,港口管制,出境,0,0,0,0
18/12/2020,十一,啟德郵輪碼頭,入境,0,0,0,0
18/12/2020,十一,啟德郵輪碼頭,出境,0,0,0,0
18/12/2020,十一,港澳客輪碼頭,入境,0,0,0,0
18/12/2020,十一,港澳客輪碼頭,出境,0,0,0,0
18/12/2020,十一,屯門客運碼頭,入境,0,0,0,0
18/12/2020,十一,屯門客運碼頭,出境,0,0,0,0
19/12/2020,十一,機場,入境,678,3,16,697
19/12/2020,十一,機場,出境,1474,14,40,1528
19/12/2020,十一,高鐵西九龍,入境,0,0,0,0
19/12/2020,十一,高鐵西九龍,出境,0,0,0,0
19/12/2020,十一,紅磡,入境,0,0,0,0
19/12/2020,十一,紅磡,出境,0,0,0,0
19/12/2020,十一,羅湖,入境,0,0,0,0
19/12/2020,十一,羅湖,出境,0,0,0,0
19/12/2020,十一,落馬洲支線,入境,0,0,0,0
19/12/2020,十一,落馬洲支線,出境,0,0,0,0
19/12/2020,十一,香園圍,入境,0,0,0,0
19/12/2020,十一,香園圍,出境,0,0,0,0
19/12/2020,十一,港珠澳大橋,入境,119,0,4,123
19/12/2020,十一,港珠澳大橋,出境,221,18,4,243
19/12/2020,十一,落馬洲,入境,0,0,0,0
19/12/2020,十一,落馬洲,出境,0,0,0,0
19/12/2020,十一,文錦渡,入境,0,0,0,0
19/12/2020,十一,文錦渡,出境,0,0,0,0
19/12/2020,十一,沙頭角,入境,0,0,0,0
19/12/2020,十一,沙頭角,出境,0,0,0,0
19/12/2020,十一,深圳灣,入境,649,55,2,706
19/12/2020,十一,深圳灣,出境,1415,162,2,1579
19/12/2020,十一,中國客運碼頭,入境,0,0,0,0
19/12/2020,十一,中國客運碼頭,出境,0,0,0,0
19/12/2020,十一,港口管制,入境,0,0,0,0
19/12/2020,十一,港口管制,出境,0,0,0,0
19/12/2020,十一,啟德郵輪碼頭,入境,0,0,0,0
19/12/2020,十一,啟德郵輪碼頭,出境,0,0,0,0
19/12/2020,十一,港澳客輪碼頭,入境,0,0,0,0
19/12/2020,十一,港澳客輪碼頭,出境,0,0,0,0
19/12/2020,十一,屯門客運碼頭,入境,0,0,0,0
19/12/2020,十一,屯門客運碼頭,出境,0,0,0,0
20/12/2020,十一,機場,入境,1088,6,39,1133
20/12/2020,十一,機場,出境,1280,28,50,1358
20/12/2020,十一,高鐵西九龍,入境,0,0,0,0
20/12/2020,十一,高鐵西九龍,出境,0,0,0,0
20/12/2020,十一,紅磡,入境,0,0,0,0
20/12/2020,十一,紅磡,出境,0,0,0,0
20/12/2020,十一,羅湖,入境,0,0,0,0
20/12/2020,十一,羅湖,出境,0,0,0,0
20/12/2020,十一,落馬洲支線,入境,0,0,0,0
20/12/2020,十一,落馬洲支線,出境,0,0,0,0
20/12/2020,十一,香園圍,入境,0,0,0,0
20/12/2020,十一,香園圍,出境,0,0,0,0
20/12/2020,十一,港珠澳大橋,入境,89,2,3,94
20/12/2020,十一,港珠澳大橋,出境,236,19,4,259
20/12/2020,十一,落馬洲,入境,0,0,0,0
20/12/2020,十一,落馬洲,出境,0,0,0,0
20/12/2020,十一,文錦渡,入境,0,0,0,0
20/12/2020,十一,文錦渡,出境,0,0,0,0
20/12/2020,十一,沙頭角,入境,0,0,0,0
20/12/2020,十一,沙頭角,出境,0,0,0,0
20/12/2020,十一,深圳灣,入境,630,73,3,706
20/12/2020,十一,深圳灣,出境,1000,119,3,1122
20/12/2020,十一,中國客運碼頭,入境,0,0,0,0
20/12/2020,十一,中國客運碼頭,出境,0,0,0,0
20/12/2020,十一,港口管制,入境,0,0,0,0
20/12/2020,十一,港口管制,出境,0,0,0,0
20/12/2020,十一,啟德郵輪碼頭,入境,0,0,0,0
20/12/2020,十一,啟德郵輪碼頭,出境,0,0,0,0
20/12/2020,十一,港澳客輪碼頭,入境,0,0,0,0
20/12/2020,十一,港澳客輪碼頭,出境,0,0,0,0
20/12/2020,十一,屯門客運碼頭,入境,0,0,0,0
20/12/2020,十一,屯門客運碼頭,出境,0,0,0,0
21/12/2020,十一,機場,入境,231,3,16,250
21/12/2020,十一,機場,出境,680,14,25,719
21/12/2020,十一,高鐵西九龍,入境,0,0,0,0
21/12/2020,十一,高鐵西九龍,出境,0,0,0,0
21/12/2020,十一,紅磡,入境,0,0,0,0
21/12/2020,十一,紅磡,出境,0,0,0,0
21/12/2020,十一,羅湖,入境,0,0,0,0
21/12/2020,十一,羅湖,出境,0,0,0,0
21/12/2020,十一,落馬洲支線,入境,0,0,0,0
21/12/2020,十一,落馬洲支線,出境,0,0,0,0
21/12/2020,十一,香園圍,入境,0,0,0,0
21/12/2020,十一,香園圍,出境,0,0,0,0
21/12/2020,十一,港珠澳大橋,入境,198,3,4,205
21/12/2020,十一,港珠澳大橋,出境,238,8,3,249
21/12/2020,十一,落馬洲,入境,0,0,0,0
21/12/2020,十一,落馬洲,出境,0,0,0,0
21/12/2020,十一,文錦渡,入境,0,0,0,0
21/12/2020,十一,文錦渡,出境,0,0,0,0
21/12/2020,十一,沙頭角,入境,0,0,0,0
21/12/2020,十一,沙頭角,出境,0,0,0,0
21/12/2020,十一,深圳灣,入境,1181,60,1,1242
21/12/2020,十一,深圳灣,出境,872,88,3,963
21/12/2020,十一,中國客運碼頭,入境,0,0,0,0
21/12/2020,十一,中國客運碼頭,出境,0,0,0,0
21/12/2020,十一,港口管制,入境,0,0,0,0
21/12/2020,十一,港口管制,出境,0,0,0,0
21/12/2020,十一,啟德郵輪碼頭,入境,0,0,0,0
21/12/2020,十一,啟德郵輪碼頭,出境,0,0,0,0
21/12/2020,十一,港澳客輪碼頭,入境,0,0,0,0
21/12/2020,十一,港澳客輪碼頭,出境,0,0,0,0
21/12/2020,十一,屯門客運碼頭,入境,0,0,0,0
21/12/2020,十一,屯門客運碼頭,出境,0,0,0,0
22/12/2020,十一,機場,入境,602,3,21,626
22/12/2020,十一,機場,出境,1059,23,24,1106
22/12/2020,十一,高鐵西九龍,入境,0,0,0,0
22/12/2020,十一,高鐵西九龍,出境,0,0,0,0
22/12/2020,十一,紅磡,入境,0,0,0,0
22/12/2020,十一,紅磡,出境,0,0,0,0
22/12/2020,十一,羅湖,入境,0,0,0,0
22/12/2020,十一,羅湖,出境,0,0,0,0
22/12/2020,十一,落馬洲支線,入境,0,0,0,0
22/12/2020,十一,落馬洲支線,出境,0,0,0,0
22/12/2020,十一,香園圍,入境,0,0,0,0
22/12/2020,十一,香園圍,出境,0,0,0,0
22/12/2020,十一,港珠澳大橋,入境,70,6,8,84
22/12/2020,十一,港珠澳大橋,出境,277,7,7,291
22/12/2020,十一,落馬洲,入境,0,0,0,0
22/12/2020,十一,落馬洲,出境,0,0,0,0
22/12/2020,十一,文錦渡,入境,0,0,0,0
22/12/2020,十一,文錦渡,出境,0,0,0,0
22/12/2020,十一,沙頭角,入境,0,0,0,0
22/12/2020,十一,沙頭角,出境,0,0,0,0
22/12/2020,十一,深圳灣,入境,1161,59,3,1223
22/12/2020,十一,深圳灣,出境,2040,201,5,2246
22/12/2020,十一,中國客運碼頭,入境,0,0,0,0
22/12/2020,十一,中國客運碼頭,出境,0,0,0,0
22/12/2020,十一,港口管制,入境,0,0,0,0
22/12/2020,十一,港口管制,出境,0,0,0,0
22/12/2020,十一,啟德郵輪碼頭,入境,0,0,0,0
22/12/2020,十一,啟德郵輪碼頭,出境,0,0,0,0
22/12/2020,十一,港澳客輪碼頭,入境,0,0,0,0
22/12/2020,十一,港澳客輪碼頭,出境,0,0,0,0
22/12/2020,十一,屯門客運碼頭,入境,0,0,0,0
22/12/2020,十一,屯門客運碼頭,出境,0,0,0,0
23/12/2020,十一,機場,入境,371,7,9,387
23/12/2020,十一,機場,出境,630,13,42,685
23/12/2020,十一,高鐵西九龍,入境,0,0,0,0
23/12/2020,十一,高鐵西九龍,出境,0,0,0,0
23/12/2020,十一,紅磡,入境,0,0,0,0
23/12/2020,十一,紅磡,出境,0,0,0,0
23/12/2020,十一,羅湖,入境,0,0,0,0
23/12/2020,十一,羅湖,出境,0,0,0,0
23/12/2020,十一,落馬洲支線,入境,0,0,0,0
23/12/2020,十一,落馬洲支線,出境,0,0,0,0
23/12/2020,十一,香園圍,入境,0,0,0,0
23/12/2020,十一,香園圍,出境,0,0,0,0
23/12/2020,十一,港珠澳大橋,入境,102,1,7,110
23/12/2020,十一,港珠澳大橋,出境,247,13,7,267
23/12/2020,十一,落馬洲,入境,0,0,0,0
23/12/2020,十一,落馬洲,出境,0,0,0,0
23/12/2020,十一,文錦渡,入境,0,0,0,0
23/12/2020,十一,文錦渡,出境,0,0,0,0
23/12/2020,十一,沙頭角,入境,0,0,0,0
23/12/2020,十一,沙頭角,出境,0,0,0,0
23/12/2020,十一,深圳灣,入境,1131,72,2,1205
23/12/2020,十一,深圳灣,出境,2643,272,2,2917
23/12/2020,十一,中國客運碼頭,入境,0,0,0,0
23/12/2020,十一,中國客運碼頭,出境,0,0,0,0
23/12/2020,十一,港口管制,入境,0,0,0,0
23/12/2020,十一,港口管制,出境,0,0,0,0
23/12/2020,十一,啟德郵輪碼頭,入境,0,0,0,0
23/12/2020,十一,啟德郵輪碼頭,出境,0,0,0,0
23/12/2020,十一,港澳客輪碼頭,入境,0,0,0,0
23/12/2020,十一,港澳客輪碼頭,出境,0,0,0,0
23/12/2020,十一,屯門客運碼頭,入境,0,0,0,0
23/12/2020,十一,屯門客運碼頭,出境,0,0,0,0
24/12/2020,十一,機場,入境,337,2,23,362
24/12/2020,十一,機場,出境,665,6,36,707
24/12/2020,十一,高鐵西九龍,入境,0,0,0,0
24/12/2020,十一,高鐵西九龍,出境,0,0,0,0
24/12/2020,十一,紅磡,入境,0,0,0,0
24/12/2020,十一,紅磡,出境,0,0,0,0
24/12/2020,十一,羅湖,入境,0,0,0,0
24/12/2020,十一,羅湖,出境,0,0,0,0
24/12/2020,十一,落馬洲支線,入境,0,0,0,0
24/12/2020,十一,落馬洲支線,出境,0,0,0,0
24/12/2020,十一,香園圍,入境,0,0,0,0
24/12/2020,十一,香園圍,出境,0,0,0,0
24/12/2020,十一,港珠澳大橋,入境,68,2,0,70
24/12/2020,十一,港珠澳大橋,出境,248,10,7,265
24/12/2020,十一,落馬洲,入境,0,0,0,0
24/12/2020,十一,落馬洲,出境,0,0,0,0
24/12/2020,十一,文錦渡,入境,0,0,0,0
24/12/2020,十一,文錦渡,出境,0,0,0,0
24/12/2020,十一,沙頭角,入境,0,0,0,0
24/12/2020,十一,沙頭角,出境,0,0,0,0
24/12/2020,十一,深圳灣,入境,1005,66,4,1075
24/12/2020,十一,深圳灣,出境,2400,254,2,2656
24/12/2020,十一,中國客運碼頭,入境,0,0,0,0
24/12/2020,十一,中國客運碼頭,出境,0,0,0,0
24/12/2020,十一,港口管制,入境,0,0,0,0
24/12/2020,十一,港口管制,出境,0,0,0,0
24/12/2020,十一,啟德郵輪碼頭,入境,0,0,0,0
24/12/2020,十一,啟德郵輪碼頭,出境,0,0,0,0
24/12/2020,十一,港澳客輪碼頭,入境,0,0,0,0
24/12/2020,十一,港澳客輪碼頭,出境,0,0,0,0
24/12/2020,十一,屯門客運碼頭,入境,0,0,0,0
24/12/2020,十一,屯門客運碼頭,出境,0,0,0,0
25/12/2020,十二,機場,入境,367,1,11,379
25/12/2020,十二,機場,出境,787,32,26,845
25/12/2020,十二,高鐵西九龍,入境,0,0,0,0
25/12/2020,十二,高鐵西九龍,出境,0,0,0,0
25/12/2020,十二,紅磡,入境,0,0,0,0
25/12/2020,十二,紅磡,出境,0,0,0,0
25/12/2020,十二,羅湖,入境,0,0,0,0
25/12/2020,十二,羅湖,出境,0,0,0,0
25/12/2020,十二,落馬洲支線,入境,0,0,0,0
25/12/2020,十二,落馬洲支線,出境,0,0,0,0
25/12/2020,十二,香園圍,入境,0,0,0,0
25/12/2020,十二,香園圍,出境,0,0,0,0
25/12/2020,十二,港珠澳大橋,入境,35,0,1,36
25/12/2020,十二,港珠澳大橋,出境,217,10,5,232
25/12/2020,十二,落馬洲,入境,0,0,0,0
25/12/2020,十二,落馬洲,出境,0,0,0,0
25/12/2020,十二,文錦渡,入境,0,0,0,0
25/12/2020,十二,文錦渡,出境,0,0,0,0
25/12/2020,十二,沙頭角,入境,0,0,0,0
25/12/2020,十二,沙頭角,出境,0,0,0,0
25/12/2020,十二,深圳灣,入境,531,44,1,576
25/12/2020,十二,深圳灣,出境,1671,205,2,1878
25/12/2020,十二,中國客運碼頭,入境,0,0,0,0
25/12/2020,十二,中國客運碼頭,出境,0,0,0,0
25/12/2020,十二,港口管制,入境,0,0,0,0
25/12/2020,十二,港口管制,出境,0,0,0,0
25/12/2020,十二,啟德郵輪碼頭,入境,0,0,0,0
25/12/2020,十二,啟德郵輪碼頭,出境,0,0,0,0
25/12/2020,十二,港澳客輪碼頭,入境,0,0,0,0
25/12/2020,十二,港澳客輪碼頭,出境,0,0,0,0
25/12/2020,十二,屯門客運碼頭,入境,0,0,0,0
25/12/2020,十二,屯門客運碼頭,出境,0,0,0,0
26/12/2020,十二,機場,入境,186,3,5,194
26/12/2020,十二,機場,出境,602,8,29,639
26/12/2020,十二,高鐵西九龍,入境,0,0,0,0
26/12/2020,十二,高鐵西九龍,出境,0,0,0,0
26/12/2020,十二,紅磡,入境,0,0,0,0
26/12/2020,十二,紅磡,出境,0,0,0,0
26/12/2020,十二,羅湖,入境,0,0,0,0
26/12/2020,十二,羅湖,出境,0,0,0,0
26/12/2020,十二,落馬洲支線,入境,0,0,0,0
26/12/2020,十二,落馬洲支線,出境,0,0,0,0
26/12/2020,十二,香園圍,入境,0,0,0,0
26/12/2020,十二,香園圍,出境,0,0,0,0
26/12/2020,十二,港珠澳大橋,入境,39,4,1,44
26/12/2020,十二,港珠澳大橋,出境,224,4,1,229
26/12/2020,十二,落馬洲,入境,0,0,0,0
26/12/2020,十二,落馬洲,出境,0,0,0,0
26/12/2020,十二,文錦渡,入境,0,0,0,0
26/12/2020,十二,文錦渡,出境,0,0,0,0
26/12/2020,十二,沙頭角,入境,0,0,0,0
26/12/2020,十二,沙頭角,出境,0,0,0,0
26/12/2020,十二,深圳灣,入境,620,48,3,671
26/12/2020,十二,深圳灣,出境,1051,129,1,1181
26/12/2020,十二,中國客運碼頭,入境,0,0,0,0
26/12/2020,十二,中國客運碼頭,出境,0,0,0,0
26/12/2020,十二,港口管制,入境,0,0,0,0
26/12/2020,十二,港口管制,出境,0,0,0,0
26/12/2020,十二,啟德郵輪碼頭,入境,0,0,0,0
26/12/2020,十二,啟德郵輪碼頭,出境,0,0,0,0
26/12/2020,十二,港澳客輪碼頭,入境,0,0,0,0
26/12/2020,十二,港澳客輪碼頭,出境,0,0,0,0
26/12/2020,十二,屯門客運碼頭,入境,0,0,0,0
26/12/2020,十二,屯門客運碼頭,出境,0,0,0,0
27/12/2020,十二,機場,入境,515,1,27,543
27/12/2020,十二,機場,出境,925,16,43,984
27/12/2020,十二,高鐵西九龍,入境,0,0,0,0
27/12/2020,十二,高鐵西九龍,出境,0,0,0,0
27/12/2020,十二,紅磡,入境,0,0,0,0
27/12/2020,十二,紅磡,出境,0,0,0,0
27/12/2020,十二,羅湖,入境,0,0,0,0
27/12/2020,十二,羅湖,出境,0,0,0,0
27/12/2020,十二,落馬洲支線,入境,0,0,0,0
27/12/2020,十二,落馬洲支線,出境,0,0,0,0
27/12/2020,十二,香園圍,入境,0,0,0,0
27/12/2020,十二,香園圍,出境,0,0,0,0
27/12/2020,十二,港珠澳大橋,入境,64,1,1,66
27/12/2020,十二,港珠澳大橋,出境,223,11,6,240
27/12/2020,十二,落馬洲,入境,0,0,0,0
27/12/2020,十二,落馬洲,出境,0,0,0,0
27/12/2020,十二,文錦渡,入境,0,0,0,0
27/12/2020,十二,文錦渡,出境,0,0,0,0
27/12/2020,十二,沙頭角,入境,0,0,0,0
27/12/2020,十二,沙頭角,出境,0,0,0,0
27/12/2020,十二,深圳灣,入境,563,49,3,615
27/12/2020,十二,深圳灣,出境,806,85,0,891
27/12/2020,十二,中國客運碼頭,入境,0,0,0,0
27/12/2020,十二,中國客運碼頭,出境,0,0,0,0
27/12/2020,十二,港口管制,入境,0,0,0,0
27/12/2020,十二,港口管制,出境,0,0,0,0
27/12/2020,十二,啟德郵輪碼頭,入境,0,0,0,0
27/12/2020,十二,啟德郵輪碼頭,出境,0,0,0,0
27/12/2020,十二,港澳客輪碼頭,入境,0,0,0,0
27/12/2020,十二,港澳客輪碼頭,出境,0,0,0,0
27/12/2020,十二,屯門客運碼頭,入境,0,0,0,0
27/12/2020,十二,屯門客運碼頭,出境,0,0,0,0
28/12/2020,十二,機場,入境,222,2,12,236
28/12/2020,十二,機場,出境,595,10,28,633
28/12/2020,十二,高鐵西九龍,入境,0,0,0,0
28/12/2020,十二,高鐵西九龍,出境,0,0,0,0
28/12/2020,十二,紅磡,入境,0,0,0,0
28/12/2020,十二,紅磡,出境,0,0,0,0
28/12/2020,十二,羅湖,入境,0,0,0,0
28/12/2020,十二,羅湖,出境,0,0,0,0
28/12/2020,十二,落馬洲支線,入境,0,0,0,0
28/12/2020,十二,落馬洲支線,出境,0,0,0,0
28/12/2020,十二,香園圍,入境,0,0,0,0
28/12/2020,十二,香園圍,出境,0,0,0,0
28/12/2020,十二,港珠澳大橋,入境,126,0,2,128
28/12/2020,十二,港珠澳大橋,出境,240,9,4,253
28/12/2020,十二,落馬洲,入境,0,0,0,0
28/12/2020,十二,落馬洲,出境,0,0,0,0
28/12/2020,十二,文錦渡,入境,0,0,0,0
28/12/2020,十二,文錦渡,出境,0,0,0,0
28/12/2020,十二,沙頭角,入境,0,0,0,0
28/12/2020,十二,沙頭角,出境,0,0,0,0
28/12/2020,十二,深圳灣,入境,1156,50,2,1208
28/12/2020,十二,深圳灣,出境,1125,90,0,1215
28/12/2020,十二,中國客運碼頭,入境,0,0,0,0
28/12/2020,十二,中國客運碼頭,出境,0,0,0,0
28/12/2020,十二,港口管制,入境,0,0,0,0
28/12/2020,十二,港口管制,出境,0,0,0,0
28/12/2020,十二,啟德郵輪碼頭,入境,0,0,0,0
28/12/2020,十二,啟德郵輪碼頭,出境,0,0,0,0
28/12/2020,十二,港澳客輪碼頭,入境,0,0,0,0
28/12/2020,十二,港澳客輪碼頭,出境,0,0,0,0
28/12/2020,十二,屯門客運碼頭,入境,0,0,0,0
28/12/2020,十二,屯門客運碼頭,出境,0,0,0,0
29/12/2020,十二,機場,入境,408,4,9,421
29/12/2020,十二,機場,出境,943,38,31,1012
29/12/2020,十二,高鐵西九龍,入境,0,0,0,0
29/12/2020,十二,高鐵西九龍,出境,0,0,0,0
29/12/2020,十二,紅磡,入境,0,0,0,0
29/12/2020,十二,紅磡,出境,0,0,0,0
29/12/2020,十二,羅湖,入境,0,0,0,0
29/12/2020,十二,羅湖,出境,0,0,0,0
29/12/2020,十二,落馬洲支線,入境,0,0,0,0
29/12/2020,十二,落馬洲支線,出境,0,0,0,0
29/12/2020,十二,香園圍,入境,0,0,0,0
29/12/2020,十二,香園圍,出境,0,0,0,0
29/12/2020,十二,港珠澳大橋,入境,90,4,1,95
29/12/2020,十二,港珠澳大橋,出境,247,16,2,265
29/12/2020,十二,落馬洲,入境,0,0,0,0
29/12/2020,十二,落馬洲,出境,0,0,0,0
29/12/2020,十二,文錦渡,入境,0,0,0,0
29/12/2020,十二,文錦渡,出境,0,0,0,0
29/12/2020,十二,沙頭角,入境,0,0,0,0
29/12/2020,十二,沙頭角,出境,0,0,0,0
29/12/2020,十二,深圳灣,入境,731,39,3,773
29/12/2020,十二,深圳灣,出境,1709,181,4,1894
29/12/2020,十二,中國客運碼頭,入境,0,0,0,0
29/12/2020,十二,中國客運碼頭,出境,0,0,0,0
29/12/2020,十二,港口管制,入境,0,0,0,0
29/12/2020,十二,港口管制,出境,0,0,0,0
29/12/2020,十二,啟德郵輪碼頭,入境,0,0,0,0
29/12/2020,十二,啟德郵輪碼頭,出境,0,0,0,0
29/12/2020,十二,港澳客輪碼頭,入境,0,0,0,0
29/12/2020,十二,港澳客輪碼頭,出境,0,0,0,0
29/12/2020,十二,屯門客運碼頭,入境,0,0,0,0
29/12/2020,十二,屯門客運碼頭,出境,0,0,0,0
30/12/2020,十二,機場,入境,648,3,23,674
30/12/2020,十二,機場,出境,656,3,48,707
30/12/2020,十二,高鐵西九龍,入境,0,0,0,0
30/12/2020,十二,高鐵西九龍,出境,0,0,0,0
30/12/2020,十二,紅磡,入境,0,0,0,0
30/12/2020,十二,紅磡,出境,0,0,0,0
30/12/2020,十二,羅湖,入境,0,0,0,0
30/12/2020,十二,羅湖,出境,0,0,0,0
30/12/2020,十二,落馬洲支線,入境,0,0,0,0
30/12/2020,十二,落馬洲支線,出境,0,0,0,0
30/12/2020,十二,香園圍,入境,0,0,0,0
30/12/2020,十二,香園圍,出境,0,0,0,0
30/12/2020,十二,港珠澳大橋,入境,75,1,3,79
30/12/2020,十二,港珠澳大橋,出境,220,12,4,236
30/12/2020,十二,落馬洲,入境,0,0,0,0
30/12/2020,十二,落馬洲,出境,0,0,0,0
30/12/2020,十二,文錦渡,入境,0,0,0,0
30/12/2020,十二,文錦渡,出境,0,0,0,0
30/12/2020,十二,沙頭角,入境,0,0,0,0
30/12/2020,十二,沙頭角,出境,0,0,0,0
30/12/2020,十二,深圳灣,入境,745,58,3,806
30/12/2020,十二,深圳灣,出境,1896,179,0,2075
30/12/2020,十二,中國客運碼頭,入境,0,0,0,0
30/12/2020,十二,中國客運碼頭,出境,0,0,0,0
30/12/2020,十二,港口管制,入境,0,0,0,0
30/12/2020,十二,港口管制,出境,0,0,0,0
30/12/2020,十二,啟德郵輪碼頭,入境,0,0,0,0
30/12/2020,十二,啟德郵輪碼頭,出境,0,0,0,0
30/12/2020,十二,港澳客輪碼頭,入境,0,0,0,0
30/12/2020,十二,港澳客輪碼頭,出境,0,0,0,0
30/12/2020,十二,屯門客運碼頭,入境,0,0,0,0
30/12/2020,十二,屯門客運碼頭,出境,0,0,0,0
31/12/2020,十二,機場,入境,317,1,17,335
31/12/2020,十二,機場,出境,751,5,42,798
31/12/2020,十二,高鐵西九龍,入境,0,0,0,0
31/12/2020,十二,高鐵西九龍,出境,0,0,0,0
31/12/2020,十二,紅磡,入境,0,0,0,0
31/12/2020,十二,紅磡,出境,0,0,0,0
31/12/2020,十二,羅湖,入境,0,0,0,0
31/12/2020,十二,羅湖,出境,0,0,0,0
31/12/2020,十二,落馬洲支線,入境,0,0,0,0
31/12/2020,十二,落馬洲支線,出境,0,0,0,0
31/12/2020,十二,香園圍,入境,0,0,0,0
31/12/2020,十二,香園圍,出境,0,0,0,0
31/12/2020,十二,港珠澳大橋,入境,56,1,1,58
31/12/2020,十二,港珠澳大橋,出境,215,16,2,233
31/12/2020,十二,落馬洲,入境,0,0,0,0
31/12/2020,十二,落馬洲,出境,0,0,0,0
31/12/2020,十二,文錦渡,入境,0,0,0,0
31/12/2020,十二,文錦渡,出境,0,0,0,0
31/12/2020,十二,沙頭角,入境,0,0,0,0
31/12/2020,十二,沙頭角,出境,0,0,0,0
31/12/2020,十二,深圳灣,入境,633,50,4,687
31/12/2020,十二,深圳灣,出境,2281,218,7,2506
31/12/2020,十二,中國客運碼頭,入境,0,0,0,0
31/12/2020,十二,中國客運碼頭,出境,0,0,0,0
31/12/2020,十二,港口管制,入境,0,0,0,0
31/12/2020,十二,港口管制,出境,0,0,0,0
31/12/2020,十二,啟德郵輪碼頭,入境,0,0,0,0
31/12/2020,十二,啟德郵輪碼頭,出境,0,0,0,0
31/12/2020,十二,港澳客輪碼頭,入境,0,0,0,0
31/12/2020,十二,港澳客輪碼頭,出境,0,0,0,0
31/12/2020,十二,屯門客運碼頭,入境,0,0,0,0
31/12/2020,十二,屯門客運碼頭,出境,0,0,0,0
